Type,Product,Started Date,Completed Date,Description,Amount,Fee,Currency,State,Balance
TOPUP,Current,2022-08-09 10:01:56,2022-08-09 10:01:56,Payment from Stripe,96.16,0.00,EUR,COMPLETED,96.16
TOPUP,Current,2022-08-12 09:38:11,2022-08-12 09:38:11,Payment from Stripe,96.16,0.00,EUR,COMPLETED,192.32
TOPUP,Current,2022-08-16 11:27:41,2022-08-16 11:27:41,Payment from Stripe,192.32,0.00,EUR,COMPLETED,384.64
FEE,Current,2022-08-16 16:57:49,2022-08-16 16:57:49,Card Delivery Fee,-6.99,0.00,EUR,COMPLETED,377.65
CARD_PAYMENT,Current,2022-08-16 14:34:34,2022-08-17 05:43:40,A2A S.p.A.,-61.08,0.00,EUR,COMPLETED,316.57
CARD_PAYMENT,Current,2022-08-24 09:25:15,2022-08-25 01:22:09,Samsung,-289.00,0.00,EUR,COMPLETED,27.57
TOPUP,Current,2022-08-25 11:29:20,2022-08-25 11:29:21,Payment from Stripe,288.48,0.00,EUR,COMPLETED,316.05
TOPUP,Current,2022-08-26 11:25:24,2022-08-26 11:25:25,Payment from Stripe,144.39,0.00,EUR,COMPLETED,460.44
CARD_PAYMENT,Current,2022-08-29 21:00:22,2022-08-30 13:09:40,Il Gelato Del G,-5.00,0.00,EUR,COMPLETED,455.44
TOPUP,Current,2022-09-02 11:38:37,2022-09-02 11:38:38,Payment from Stripe,240.55,0.00,EUR,COMPLETED,695.99
TOPUP,Current,2022-09-09 11:33:48,2022-09-09 11:33:49,Payment from Stripe,722.55,0.00,EUR,COMPLETED,1418.54
CARD_PAYMENT,Current,2022-09-09 17:50:33,2022-09-11 10:45:17,Bistrot PolEATecnico Milano,-5.00,0.00,EUR,COMPLETED,1413.54
CARD_PAYMENT,Current,2022-09-11 17:48:21,2022-09-12 15:22:06,Decathlon,-17.18,0.00,EUR,COMPLETED,1396.36
CARD_PAYMENT,Current,2022-09-10 18:20:23,2022-09-12 15:23:48,Food Concept,-3.50,0.00,EUR,COMPLETED,1392.86
CARD_PAYMENT,Current,2022-09-11 09:07:57,2022-09-12 19:05:40,L.a. Srl Semplificata,-2.60,0.00,EUR,COMPLETED,1390.26
CARD_PAYMENT,Current,2022-09-10 20:09:25,2022-09-13 10:30:34,Portobello,-6.00,0.00,EUR,COMPLETED,1384.26
CARD_PAYMENT,Current,2022-09-12 12:47:57,2022-09-13 15:46:39,Carrefour,-1.36,0.00,EUR,COMPLETED,1382.90
CARD_PAYMENT,Current,2022-09-12 12:48:22,2022-09-13 15:46:39,Carrefour,-8.47,0.00,EUR,COMPLETED,1374.43
CARD_PAYMENT,Current,2022-09-15 19:10:59,2022-09-16 13:43:37,Lafarmacia.Brianza,-11.98,0.00,EUR,COMPLETED,1362.45
CARD_PAYMENT,Current,2022-09-15 11:15:00,2022-09-16 17:27:10,Politecnico Leonardo,-6.00,0.00,EUR,COMPLETED,1356.45
CARD_PAYMENT,Current,2022-09-15 15:51:07,2022-09-16 17:27:10,Politecnico Leonardo,-2.50,0.00,EUR,COMPLETED,1353.95
CARD_PAYMENT,Current,2022-09-15 19:42:06,2022-09-17 11:11:23,Conad,-9.22,0.00,EUR,COMPLETED,1344.73
TOPUP,Current,2022-09-27 11:25:19,2022-09-27 11:25:19,Payment from Stripe,192.32,0.00,EUR,COMPLETED,1537.05
TOPUP,Current,2022-09-28 11:32:30,2022-09-28 11:32:30,Payment from Stripe,481.40,0.00,EUR,COMPLETED,2018.45
TOPUP,Current,2022-09-29 09:56:08,2022-09-29 09:56:09,Payment from Stripe,144.39,0.00,EUR,COMPLETED,2162.84
TOPUP,Current,2022-09-30 10:17:57,2022-09-30 10:17:57,Payment from Stripe,96.16,0.00,EUR,COMPLETED,2259.00
TOPUP,Current,2022-10-03 10:32:13,2022-10-03 10:32:13,Payment from Stripe,481.70,0.00,EUR,COMPLETED,2740.70
TOPUP,Current,2022-10-03 10:32:56,2022-10-03 10:32:57,Payment from Stripe,481.70,0.00,EUR,COMPLETED,3222.40
TOPUP,Current,2022-10-03 10:33:02,2022-10-03 10:33:02,Payment from Stripe,337.01,0.00,EUR,COMPLETED,3559.41
TOPUP,Current,2022-10-10 10:14:30,2022-10-10 10:14:31,Payment from Stripe,96.16,0.00,EUR,COMPLETED,3655.57
TOPUP,Current,2022-10-10 10:17:52,2022-10-10 10:17:52,Payment from Stripe,337.01,0.00,EUR,COMPLETED,3992.58
TOPUP,Current,2022-10-12 10:00:29,2022-10-12 10:00:29,Payment from Stripe,96.16,0.00,EUR,COMPLETED,4088.74
TOPUP,Current,2022-10-13 09:40:11,2022-10-13 09:40:12,Payment from Stripe,96.16,0.00,EUR,COMPLETED,4184.90
TOPUP,Current,2022-10-14 11:28:12,2022-10-14 11:28:13,Payment from Stripe,96.16,0.00,EUR,COMPLETED,4281.06
TOPUP,Current,2022-11-07 10:28:30,2022-11-07 10:28:30,Payment from Stripe,192.32,0.00,EUR,COMPLETED,4473.38
TOPUP,Current,2022-11-07 10:30:46,2022-11-07 10:30:46,Payment from Stripe,144.39,0.00,EUR,COMPLETED,4617.77
TOPUP,Current,2022-11-09 10:03:09,2022-11-09 10:03:10,Payment from Stripe,284.25,0.00,EUR,COMPLETED,4902.02
TOPUP,Current,2022-11-11 09:57:53,2022-11-11 09:57:54,Payment from Stripe,284.25,0.00,EUR,COMPLETED,5186.27
TOPUP,Current,2022-11-17 09:52:28,2022-11-17 09:52:28,Payment from Stripe,284.25,0.00,EUR,COMPLETED,5470.52
CARD_PAYMENT,Current,2022-11-20 13:17:54,2022-11-21 12:40:35,Carrefour,-10.08,0.00,EUR,COMPLETED,5460.44
CARD_PAYMENT,Current,2022-11-19 13:29:50,2022-11-21 12:40:36,Carrefour,-9.62,0.00,EUR,COMPLETED,5450.82
CARD_PAYMENT,Current,2022-11-21 18:01:55,2022-11-22 12:08:06,Esselunga,-5.65,0.00,EUR,COMPLETED,5445.17
CARD_PAYMENT,Current,2022-11-21 12:16:55,2022-11-22 12:10:36,Politecnico di Milano,-7.00,0.00,EUR,COMPLETED,5438.17
CARD_PAYMENT,Current,2022-11-22 13:47:17,2022-11-23 12:49:23,Odontoiatrica S. Michele,-29.00,0.00,EUR,COMPLETED,5409.17
CARD_PAYMENT,Current,2022-11-23 17:44:55,2022-11-24 12:23:51,Esselunga,-18.78,0.00,EUR,COMPLETED,5390.39
CARD_PAYMENT,Current,2022-11-23 13:15:07,2022-11-24 12:27:08,Politecnico di Milano,-21.00,0.00,EUR,COMPLETED,5369.39
CARD_PAYMENT,Current,2022-11-23 16:33:37,2022-11-24 12:27:47,Farmacia Calo Del Dr. C,-18.00,0.00,EUR,COMPLETED,5351.39
CARD_PAYMENT,Current,2022-11-23 09:51:33,2022-11-24 12:27:47,Asst Nord Milano Poliamb,-17.90,0.00,EUR,COMPLETED,5333.49
CARD_PAYMENT,Current,2022-11-23 10:51:12,2022-11-24 12:27:48,Farmacia Calo Del Dr. C,-3.44,0.00,EUR,COMPLETED,5330.05
CARD_PAYMENT,Current,2022-11-24 11:15:43,2022-11-25 12:20:08,Vodafone,-3.30,0.00,EUR,COMPLETED,5326.75
CARD_PAYMENT,Current,2022-11-25 18:16:41,2022-11-26 13:03:16,Esselunga,-14.73,0.00,EUR,COMPLETED,5312.02
CARD_PAYMENT,Current,2022-11-25 13:30:55,2022-11-26 13:09:29,Politecnico di Milano,-14.00,0.00,EUR,COMPLETED,5298.02
CARD_PAYMENT,Current,2022-11-27 12:46:58,2022-11-28 11:44:10,Carrefour,-5.94,0.00,EUR,COMPLETED,5292.08
CARD_PAYMENT,Current,2022-11-28 12:05:52,2022-11-29 12:35:40,Politecnico di Milano,-7.00,0.00,EUR,COMPLETED,5285.08
CARD_PAYMENT,Current,2022-11-29 11:55:34,2022-11-30 11:55:34,Politecnico di Milano,-7.00,0.00,EUR,COMPLETED,5278.08
CARD_PAYMENT,Current,2022-11-30 13:15:43,2022-12-01 12:00:50,Politecnico di Milano,-7.00,0.00,EUR,COMPLETED,5271.08
CARD_PAYMENT,Current,2022-12-01 20:24:00,2022-12-02 12:51:34,Esselunga,-16.89,0.00,EUR,COMPLETED,5254.19
CARD_PAYMENT,Current,2022-12-01 10:55:40,2022-12-02 12:57:14,Politecnico Leonardo,-6.00,0.00,EUR,COMPLETED,5248.19
CARD_PAYMENT,Current,2022-12-02 12:55:53,2022-12-03 13:04:55,Politecnico di Milano,-7.00,0.00,EUR,COMPLETED,5241.19
CARD_PAYMENT,Current,2022-12-04 13:34:07,2022-12-05 11:47:50,Carrefour,-8.53,0.00,EUR,COMPLETED,5232.66
CARD_PAYMENT,Current,2022-12-03 13:02:26,2022-12-05 15:19:23,Pizzalandia Due,-7.00,0.00,EUR,COMPLETED,5225.66
CARD_PAYMENT,Current,2022-12-05 17:13:34,2022-12-06 10:38:21,Bps Polimi Campo Giuria,-8.00,0.00,EUR,COMPLETED,5217.66
CARD_PAYMENT,Current,2022-12-05 20:30:11,2022-12-06 11:46:37,Esselunga,-7.59,0.00,EUR,COMPLETED,5210.07
CARD_PAYMENT,Current,2022-12-05 12:01:51,2022-12-06 11:47:38,Pizzalandia Due,-4.00,0.00,EUR,COMPLETED,5206.07
CARD_PAYMENT,Current,2022-12-06 17:21:17,2022-12-07 11:37:40,Esselunga,-4.96,0.00,EUR,COMPLETED,5201.11
CARD_PAYMENT,Current,2022-12-06 09:13:19,2022-12-07 11:43:08,Carrefour,-5.04,0.00,EUR,COMPLETED,5196.07
CARD_PAYMENT,Current,2022-12-06 17:04:40,2022-12-07 12:05:28,Gran Market 5 S.r.l. ..,-9.39,0.00,EUR,COMPLETED,5186.68
CARD_PAYMENT,Current,2022-12-07 13:33:48,2022-12-08 11:30:26,Carrefour,-11.04,0.00,EUR,COMPLETED,5175.64
CARD_PAYMENT,Current,2022-12-08 13:20:39,2022-12-09 11:56:56,Carrefour,-5.46,0.00,EUR,COMPLETED,5170.18
CARD_PAYMENT,Current,2022-12-09 13:10:49,2022-12-10 12:27:11,Carrefour,-0.72,0.00,EUR,COMPLETED,5169.46
CARD_PAYMENT,Current,2022-12-11 09:09:53,2022-12-12 11:30:52,Carrefour,-5.34,0.00,EUR,COMPLETED,5164.12
CARD_PAYMENT,Current,2022-12-11 13:12:16,2022-12-12 11:30:52,Carrefour,-3.53,0.00,EUR,COMPLETED,5160.59
CARD_PAYMENT,Current,2022-12-10 13:05:38,2022-12-12 11:50:35,Pizzalandia Due,-7.00,0.00,EUR,COMPLETED,5153.59
CARD_PAYMENT,Current,2022-12-12 12:34:26,2022-12-13 11:34:20,Politecnico di Milano,-7.00,0.00,EUR,COMPLETED,5146.59
CARD_PAYMENT,Current,2022-12-12 07:49:39,2022-12-13 11:35:03,Asst Ss Paolo Carlo Mi,-9.75,0.00,EUR,COMPLETED,5136.84
CARD_PAYMENT,Current,2022-12-13 12:23:57,2022-12-14 11:52:21,Politecnico di Milano,-7.00,0.00,EUR,COMPLETED,5129.84
CARD_PAYMENT,Current,2022-12-14 13:26:11,2022-12-15 16:05:18,Politecnico di Milano,-7.00,0.00,EUR,COMPLETED,5122.84
CARD_PAYMENT,Current,2022-12-14 07:46:32,2022-12-16 10:16:51,Asst Fatebenefratelli Sac,-20.15,0.00,EUR,COMPLETED,5102.69
CARD_PAYMENT,Current,2022-12-15 13:29:52,2022-12-16 11:59:58,Politecnico di Milano,-7.00,0.00,EUR,COMPLETED,5095.69
CARD_PAYMENT,Current,2022-12-15 09:19:24,2022-12-16 12:00:17,Asst Ss Paolo Carlo Mi,-17.90,0.00,EUR,COMPLETED,5077.79
CARD_PAYMENT,Current,2022-12-15 08:16:43,2022-12-16 12:00:17,Asst Ss Paolo Carlo Mi,-17.90,0.00,EUR,COMPLETED,5059.89
CARD_PAYMENT,Current,2022-12-16 13:38:38,2022-12-17 11:43:46,Politecnico di Milano,-7.00,0.00,EUR,COMPLETED,5052.89
CARD_PAYMENT,Current,2022-12-17 12:30:56,2022-12-19 11:07:08,Carrefour,-6.66,0.00,EUR,COMPLETED,5046.23
CARD_PAYMENT,Current,2022-12-19 12:09:37,2022-12-20 11:34:41,Politecnico di Milano,-14.00,0.00,EUR,COMPLETED,5032.23
CARD_PAYMENT,Current,2022-12-20 13:26:07,,Politecnico Leonardo,-7.00,0.00,EUR,REVERTED,
CARD_PAYMENT,Current,2022-12-20 19:16:35,2022-12-21 16:52:36,Esselunga,-10.08,0.00,EUR,COMPLETED,5022.15
CARD_PAYMENT,Current,2022-12-20 11:19:49,2022-12-21 17:06:19,Farmacia Brianza,-3.44,0.00,EUR,COMPLETED,5018.71
CARD_PAYMENT,Current,2022-12-20 13:26:27,2022-12-21 19:14:30,Politecnico di Milano,-7.00,0.00,EUR,COMPLETED,5011.71
CARD_PAYMENT,Current,2022-12-21 13:16:03,2022-12-22 23:03:56,Politecnico di Milano,-7.00,0.00,EUR,COMPLETED,5004.71
CARD_PAYMENT,Current,2022-12-22 16:11:54,2022-12-23 10:22:31,PittaRosso,-43.24,0.00,EUR,COMPLETED,4961.47
CARD_PAYMENT,Current,2022-12-22 16:28:39,2022-12-23 12:04:16,Terranova,-46.15,0.00,EUR,COMPLETED,4915.32
CARD_PAYMENT,Current,2022-12-22 11:00:01,2022-12-23 13:42:21,Politecnico Leonardo,-8.00,0.00,EUR,COMPLETED,4907.32
CARD_PAYMENT,Current,2022-12-22 17:03:38,2022-12-23 13:42:31,072 Mondo Lindt Mi Caste,-79.08,0.00,EUR,COMPLETED,4828.24
CARD_PAYMENT,Current,2022-12-23 13:04:01,2022-12-24 16:05:06,Politecnico di Milano,-7.00,0.00,EUR,COMPLETED,4821.24
CARD_PAYMENT,Current,2022-12-29 16:15:57,2022-12-30 12:08:28,Farmacia Sangiananton..,-5.40,0.00,EUR,COMPLETED,4815.84
CARD_PAYMENT,Current,2023-01-03 19:30:00,2023-01-05 10:51:57,Conad,-2.69,0.00,EUR,COMPLETED,4813.15
CARD_PAYMENT,Current,2023-01-04 15:07:16,2023-01-05 12:09:27,Carrefour,-2.49,0.00,EUR,COMPLETED,4810.66
CARD_PAYMENT,Current,2023-01-05 18:46:18,2023-01-07 11:36:28,Esselunga,-4.48,0.00,EUR,COMPLETED,4806.18
CARD_PAYMENT,Current,2023-01-07 18:36:04,2023-01-08 10:20:25,Diva Parrucchiere,-22.00,0.00,EUR,COMPLETED,4784.18
CARD_PAYMENT,Current,2023-01-08 13:24:39,2023-01-09 11:10:58,Carrefour,-5.96,0.00,EUR,COMPLETED,4778.22
CARD_PAYMENT,Current,2023-01-07 19:30:35,2023-01-09 11:14:43,Esselunga,-8.23,0.00,EUR,COMPLETED,4769.99
CARD_PAYMENT,Current,2023-01-09 12:36:33,2023-01-10 11:40:53,Politecnico di Milano,-7.00,0.00,EUR,COMPLETED,4762.99
CARD_PAYMENT,Current,2023-01-10 12:33:49,2023-01-11 11:24:14,Politecnico di Milano,-7.00,0.00,EUR,COMPLETED,4755.99
CARD_PAYMENT,Current,2023-01-11 14:12:28,2023-01-12 11:49:45,Politecnico di Milano,-7.00,0.00,EUR,COMPLETED,4748.99
CARD_PAYMENT,Current,2023-01-12 12:40:42,2023-01-13 12:18:41,Politecnico di Milano,-7.00,0.00,EUR,COMPLETED,4741.99
CARD_PAYMENT,Current,2023-01-12 15:34:09,2023-01-14 10:30:12,Farmacia De Poli Sas Dr,-2.00,0.00,EUR,COMPLETED,4739.99
CARD_PAYMENT,Current,2023-01-13 13:25:22,2023-01-14 11:50:49,Politecnico di Milano,-7.00,0.00,EUR,COMPLETED,4732.99
CARD_PAYMENT,Current,2023-01-13 16:51:31,2023-01-14 11:58:30,Carrefour,-10.88,0.00,EUR,COMPLETED,4722.11
TRANSFER,Current,2023-01-14 12:25:56,2023-01-14 12:25:56,From RONGOU ZHOU,9.50,0.00,EUR,COMPLETED,4731.61
CARD_PAYMENT,Current,2023-01-13 07:51:17,2023-01-15 09:42:59,Asst Fatebenefratelli Sac,-21.15,0.00,EUR,COMPLETED,4710.46
CARD_PAYMENT,Current,2023-01-13 08:20:32,2023-01-15 09:42:59,Jolly Student Food,-1.30,0.00,EUR,COMPLETED,4709.16
CARD_PAYMENT,Current,2023-01-15 19:03:04,2023-01-17 01:31:57,Carrefour,-12.79,0.00,EUR,COMPLETED,4696.37
CARD_PAYMENT,Current,2023-01-14 12:24:46,2023-01-17 01:46:47,Pizzalandia Due,-43.50,0.00,EUR,COMPLETED,4652.87
CARD_PAYMENT,Current,2023-01-16 19:28:16,2023-01-17 11:08:07,Carrefour,-8.98,0.00,EUR,COMPLETED,4643.89
CARD_PAYMENT,Current,2023-01-16 13:17:14,2023-01-17 11:11:14,Politecnico di Milano,-7.00,0.00,EUR,COMPLETED,4636.89
CARD_PAYMENT,Current,2023-01-16 19:30:35,2023-01-17 11:12:33,Farmacia Sant'anna Sas D,-4.00,0.00,EUR,COMPLETED,4632.89
CARD_PAYMENT,Current,2023-01-17 10:54:14,2023-01-18 11:05:11,Elettromorgantini,-4.50,0.00,EUR,COMPLETED,4628.39
CARD_PAYMENT,Current,2023-01-17 10:46:16,2023-01-18 11:32:01,Esselunga,-10.84,0.00,EUR,COMPLETED,4617.55
CARD_PAYMENT,Current,2023-01-17 09:13:08,2023-01-18 11:35:09,Asst Ss Paolo Carlo Mi,-17.90,0.00,EUR,COMPLETED,4599.65
CARD_PAYMENT,Current,2023-01-17 11:01:19,2023-01-19 11:17:36,Flli Cassetta,-4.00,0.00,EUR,COMPLETED,4595.65
CARD_PAYMENT,Current,2023-01-18 12:30:11,2023-01-19 12:38:45,Politecnico di Milano,-7.00,0.00,EUR,COMPLETED,4588.65
CARD_PAYMENT,Current,2023-01-19 18:35:29,2023-01-20 11:26:32,Carrefour,-14.00,0.00,EUR,COMPLETED,4574.65
CARD_PAYMENT,Current,2023-01-19 12:13:13,2023-01-20 11:33:28,Politecnico Leonardo,-4.00,0.00,EUR,COMPLETED,4570.65
CARD_PAYMENT,Current,2023-01-20 19:14:40,2023-01-21 11:49:25,Farmacia Sant'anna Sas D,-3.44,0.00,EUR,COMPLETED,4567.21
CARD_PAYMENT,Current,2023-01-20 12:42:49,2023-01-21 11:54:09,Politecnico di Milano,-7.00,0.00,EUR,COMPLETED,4560.21
CARD_PAYMENT,Current,2023-01-22 12:21:03,2023-01-23 11:44:50,Esselunga,-13.72,0.00,EUR,COMPLETED,4546.49
CARD_PAYMENT,Current,2023-01-23 12:57:53,2023-01-24 11:14:06,Politecnico di Milano,-7.00,0.00,EUR,COMPLETED,4539.49
CARD_PAYMENT,Current,2023-01-24 12:44:11,2023-01-25 12:23:09,Politecnico di Milano,-7.00,0.00,EUR,COMPLETED,4532.49
CARD_PAYMENT,Current,2023-01-25 19:11:12,2023-01-26 12:10:14,Farmacia Sant'anna Sas D,-12.90,0.00,EUR,COMPLETED,4519.59
CARD_PAYMENT,Current,2023-01-25 12:43:06,2023-01-27 10:45:05,Politecnico di Milano,-7.00,0.00,EUR,COMPLETED,4512.59
CARD_PAYMENT,Current,2023-01-25 10:25:38,2023-01-27 10:54:20,Fond Irccs Istituto Neuro,-22.50,0.00,EUR,COMPLETED,4490.09
CARD_PAYMENT,Current,2023-01-27 18:16:15,2023-01-28 12:07:38,Esselunga,-12.52,0.00,EUR,COMPLETED,4477.57
CARD_PAYMENT,Current,2023-01-27 12:16:40,2023-01-28 12:09:39,Politecnico di Milano,-7.00,0.00,EUR,COMPLETED,4470.57
CARD_PAYMENT,Current,2023-01-29 09:52:45,2023-01-31 19:37:20,Esselunga,-20.00,0.00,EUR,COMPLETED,4450.57
CARD_PAYMENT,Current,2023-01-30 12:15:10,2023-01-31 21:13:23,Politecnico di Milano,-7.00,0.00,EUR,COMPLETED,4443.57
CARD_PAYMENT,Current,2023-01-31 12:44:37,2023-02-01 13:09:26,Politecnico di Milano,-7.00,0.00,EUR,COMPLETED,4436.57
CARD_PAYMENT,Current,2023-02-01 12:46:40,2023-02-02 12:03:19,Politecnico di Milano,-7.00,0.00,EUR,COMPLETED,4429.57
CARD_PAYMENT,Current,2023-02-02 13:25:46,2023-02-03 11:49:53,Politecnico di Milano,-7.00,0.00,EUR,COMPLETED,4422.57
CARD_PAYMENT,Current,2023-02-04 19:58:11,2023-02-06 11:33:33,Carrefour,-10.19,0.00,EUR,COMPLETED,4412.38
CARD_PAYMENT,Current,2023-02-05 19:00:21,2023-02-06 11:33:33,Carrefour,-13.43,0.00,EUR,COMPLETED,4398.95
CARD_PAYMENT,Current,2023-02-04 12:55:06,2023-02-06 11:33:34,Carrefour,-8.79,0.00,EUR,COMPLETED,4390.16
CARD_PAYMENT,Current,2023-02-06 12:29:33,2023-02-07 12:25:22,Politecnico di Milano,-7.00,0.00,EUR,COMPLETED,4383.16
CARD_PAYMENT,Current,2023-02-06 12:30:06,2023-02-07 12:25:22,Politecnico di Milano,-70.00,0.00,EUR,COMPLETED,4313.16
CARD_PAYMENT,Current,2023-02-10 20:30:21,2023-02-11 12:09:23,Esselunga,-5.37,0.00,EUR,COMPLETED,4307.79
CARD_PAYMENT,Current,2023-02-11 19:52:52,2023-02-13 11:43:04,Esselunga,-11.08,0.00,EUR,COMPLETED,4296.71
CARD_PAYMENT,Current,2023-02-11 19:56:11,2023-02-14 09:56:18,Panificio Pasticceria,-5.70,0.00,EUR,COMPLETED,4291.01
CARD_PAYMENT,Current,2023-02-15 18:01:33,2023-02-16 12:59:20,Diva Parrucchiere,-12.00,0.00,EUR,COMPLETED,4279.01
CARD_PAYMENT,Current,2023-02-15 08:16:15,2023-02-17 10:49:51,Asst Fatebenefratelli Sac,-20.50,0.00,EUR,COMPLETED,4258.51
CARD_PAYMENT,Current,2023-02-16 09:07:50,2023-02-17 12:18:47,Asst Ss Paolo Carlo Mi,-17.90,0.00,EUR,COMPLETED,4240.61
CARD_PAYMENT,Current,2023-02-17 17:59:13,2023-02-18 17:00:57,Farmacia Sant'anna Sas D,-21.90,0.00,EUR,COMPLETED,4218.71
CARD_PAYMENT,Current,2023-02-18 12:09:40,2023-02-20 11:48:50,Esselunga,-12.93,0.00,EUR,COMPLETED,4205.78
CARD_PAYMENT,Current,2023-02-19 10:41:30,2023-02-21 10:07:18,Via Andrea Costa 2,-7.40,0.00,EUR,COMPLETED,4198.38
CARD_PAYMENT,Current,2023-02-20 19:30:15,2023-02-21 11:26:35,Farmacia Sant'anna Sas D,-23.30,0.00,EUR,COMPLETED,4175.08
CARD_PAYMENT,Current,2023-02-20 13:04:23,2023-02-21 12:23:32,Vodafone,-4.00,0.00,EUR,COMPLETED,4171.08
CARD_PAYMENT,Current,2023-02-21 18:58:02,2023-02-22 11:56:52,Esselunga,-8.16,0.00,EUR,COMPLETED,4162.92
CARD_PAYMENT,Current,2023-02-21 18:10:42,2023-02-22 12:03:40,Farmacia Calo Del Dr. C,-3.44,0.00,EUR,COMPLETED,4159.48
CARD_PAYMENT,Current,2023-02-24 18:47:30,2023-02-25 15:25:48,Esselunga,-15.41,0.00,EUR,COMPLETED,4144.07
CARD_PAYMENT,Current,2023-02-25 11:33:56,2023-02-28 10:23:30,Jolly Student Food,-1.30,0.00,EUR,COMPLETED,4142.77
CARD_PAYMENT,Current,2023-02-28 18:43:34,2023-03-01 15:58:38,Esselunga,-12.26,0.00,EUR,COMPLETED,4130.51
CARD_PAYMENT,Current,2023-03-02 12:57:44,2023-03-03 14:10:55,Politecnico di Milano,-7.00,0.00,EUR,COMPLETED,4123.51
CARD_PAYMENT,Current,2023-03-03 12:54:48,2023-03-04 12:16:21,Politecnico di Milano,-5.50,0.00,EUR,COMPLETED,4118.01
CARD_PAYMENT,Current,2023-03-04 12:58:10,2023-03-06 12:07:20,Pizzalandia Due,-7.00,0.00,EUR,COMPLETED,4111.01
CARD_PAYMENT,Current,2023-03-06 20:25:45,2023-03-07 11:44:36,Carrefour,-10.69,0.00,EUR,COMPLETED,4100.32
CARD_PAYMENT,Current,2023-03-07 14:54:54,2023-03-08 17:10:25,Campisi Snc,-5.00,0.00,EUR,COMPLETED,4095.32
CARD_PAYMENT,Current,2023-03-08 12:47:16,2023-03-09 12:30:38,Politecnico di Milano,-7.00,0.00,EUR,COMPLETED,4088.32
CARD_PAYMENT,Current,2023-03-08 12:48:27,2023-03-09 12:30:38,Politecnico di Milano,-55.00,0.00,EUR,COMPLETED,4033.32
CARD_PAYMENT,Current,2023-03-09 12:49:01,2023-03-10 16:38:47,Politecnico di Milano,-7.00,0.00,EUR,COMPLETED,4026.32
CARD_PAYMENT,Current,2023-03-12 18:04:49,2023-03-13 10:14:32,H&M,-14.18,0.00,EUR,COMPLETED,4012.14
CARD_PAYMENT,Current,2023-03-12 17:30:03,2023-03-14 10:07:13,Terranova,-36.15,0.00,EUR,COMPLETED,3975.99
CARD_PAYMENT,Current,2023-03-11 17:12:10,2023-03-14 10:19:08,Farmacia Ambreck,-23.89,0.00,EUR,COMPLETED,3952.10
CARD_PAYMENT,Current,2023-03-11 18:48:05,2023-03-14 10:19:44,Esselunga,-20.76,0.00,EUR,COMPLETED,3931.34
CARD_PAYMENT,Current,2023-03-13 13:11:17,2023-03-14 12:48:49,Politecnico di Milano,-7.00,0.00,EUR,COMPLETED,3924.34
CARD_PAYMENT,Current,2023-03-13 11:53:57,2023-03-14 13:11:28,Associazione Territor..,-16.50,0.00,EUR,COMPLETED,3907.84
CARD_PAYMENT,Current,2023-03-13 09:42:39,2023-03-15 10:36:57,Politecnico di Milano,-1.60,0.00,EUR,COMPLETED,3906.24
CARD_PAYMENT,Current,2023-03-14 19:04:04,2023-03-15 12:57:16,Carrefour,-11.88,0.00,EUR,COMPLETED,3894.36
CARD_PAYMENT,Current,2023-03-15 23:14:40,2023-03-17 21:18:35,Playup Milano,-55.00,0.00,EUR,COMPLETED,3839.36
CARD_PAYMENT,Current,2023-03-18 12:28:33,2023-03-21 00:37:56,Carrefour,-5.81,0.00,EUR,COMPLETED,3833.55
CARD_PAYMENT,Current,2023-03-19 11:58:33,2023-03-21 00:46:23,Esselunga,-20.56,0.00,EUR,COMPLETED,3812.99
CARD_PAYMENT,Current,2023-03-20 19:24:09,2023-03-21 12:54:54,Carrefour,-17.29,0.00,EUR,COMPLETED,3795.70
CARD_PAYMENT,Current,2023-03-21 07:46:12,2023-03-23 10:24:26,Asst Fatebenefratelli Sac,-8.60,0.00,EUR,COMPLETED,3787.10
CARD_PAYMENT,Current,2023-03-22 08:32:51,2023-03-23 14:10:45,Asst Ss Paolo Carlo Mi,-17.90,0.00,EUR,COMPLETED,3769.20
CARD_PAYMENT,Current,2023-03-23 12:26:13,2023-03-24 13:14:03,Politecnico di Milano,-7.00,0.00,EUR,COMPLETED,3762.20
CARD_PAYMENT,Current,2023-03-24 17:36:34,2023-03-25 13:19:10,Esselunga,-33.37,0.00,EUR,COMPLETED,3728.83
CARD_PAYMENT,Current,2023-03-25 18:14:24,2023-03-27 12:05:56,Esselunga,-10.93,0.00,EUR,COMPLETED,3717.90
CARD_PAYMENT,Current,2023-03-30 12:22:56,2023-03-31 14:03:35,Politecnico di Milano,-7.00,0.00,EUR,COMPLETED,3710.90
CARD_PAYMENT,Current,2023-03-31 18:12:20,2023-04-01 13:51:15,Esselunga,-24.18,0.00,EUR,COMPLETED,3686.72
CARD_PAYMENT,Current,2023-04-01 20:15:47,2023-04-03 12:00:44,Carrefour,-17.37,0.00,EUR,COMPLETED,3669.35
CARD_PAYMENT,Current,2023-04-02 18:02:29,2023-04-03 12:31:50,Kasanova,-54.70,0.00,EUR,COMPLETED,3614.65
CARD_PAYMENT,Current,2023-04-06 12:43:15,2023-04-07 13:09:27,Politecnico di Milano,-7.00,0.00,EUR,COMPLETED,3607.65
CARD_PAYMENT,Current,2023-04-06 18:55:31,2023-04-07 13:09:40,072 Mondo Lindt Mi Caste,-7.70,0.00,EUR,COMPLETED,3599.95
CARD_PAYMENT,Current,2023-04-07 20:04:21,2023-04-08 11:32:10,Carrefour,-3.78,0.00,EUR,COMPLETED,3596.17
CARD_PAYMENT,Current,2023-04-07 12:54:03,2023-04-08 14:20:02,Politecnico di Milano,-7.00,0.00,EUR,COMPLETED,3589.17
CARD_PAYMENT,Current,2023-04-07 09:02:53,2023-04-08 14:33:27,Libreria Cortina - Università Statale,-19.00,0.00,EUR,COMPLETED,3570.17
CARD_PAYMENT,Current,2023-04-07 19:25:07,2023-04-09 10:54:43,Conad,-2.99,0.00,EUR,COMPLETED,3567.18
CARD_PAYMENT,Current,2023-04-07 19:28:36,2023-04-09 10:54:43,Trovi tutto,-2.50,0.00,EUR,COMPLETED,3564.68
CARD_PAYMENT,Current,2023-04-08 14:08:37,2023-04-10 11:41:23,Carrefour,-2.58,0.00,EUR,COMPLETED,3562.10
CARD_PAYMENT,Current,2023-04-09 11:24:01,2023-04-10 11:41:23,Carrefour,-12.39,0.00,EUR,COMPLETED,3549.71
CARD_PAYMENT,Current,2023-04-11 19:46:33,2023-04-12 12:59:34,Laesse Buenos Aires,-4.99,0.00,EUR,COMPLETED,3544.72
CARD_PAYMENT,Current,2023-04-12 12:54:34,2023-04-13 15:36:57,Politecnico di Milano,-7.00,0.00,EUR,COMPLETED,3537.72
CARD_PAYMENT,Current,2023-04-13 13:05:03,2023-04-14 14:57:14,Politecnico di Milano,-7.00,0.00,EUR,COMPLETED,3530.72
CARD_PAYMENT,Current,2023-04-14 20:25:21,2023-04-15 13:02:33,Esselunga,-8.54,0.00,EUR,COMPLETED,3522.18
CARD_PAYMENT,Current,2023-04-15 13:11:08,2023-04-17 12:21:06,Padelletta,-6.00,0.00,EUR,COMPLETED,3516.18
CARD_PAYMENT,Current,2023-04-18 07:39:14,2023-04-19 12:12:21,Carrefour,-4.29,0.00,EUR,COMPLETED,3511.89
CARD_PAYMENT,Current,2023-04-18 12:57:40,2023-04-19 12:44:20,Politecnico di Milano,-7.00,0.00,EUR,COMPLETED,3504.89
CARD_PAYMENT,Current,2023-04-18 16:47:26,2023-04-20 11:08:43,Politecnico di Milano,-5.00,0.00,EUR,COMPLETED,3499.89
CARD_PAYMENT,Current,2023-04-18 08:25:24,2023-04-20 11:08:43,Asst Fatebenefratelli Sac,-8.60,0.00,EUR,COMPLETED,3491.29
CARD_PAYMENT,Current,2023-04-20 08:28:30,2023-04-21 15:31:33,Asst Ss Paolo Carlo Mi,-17.90,0.00,EUR,COMPLETED,3473.39
CARD_PAYMENT,Current,2023-04-21 13:44:51,2023-04-22 15:34:12,Omi,-19.00,0.00,EUR,COMPLETED,3454.39
CARD_PAYMENT,Current,2023-04-23 19:38:51,2023-04-24 12:11:07,Carrefour,-10.55,0.00,EUR,COMPLETED,3443.84
CARD_PAYMENT,Current,2023-04-22 17:21:10,2023-04-24 12:27:45,Esselunga,-7.31,0.00,EUR,COMPLETED,3436.53
CARD_PAYMENT,Current,2023-04-24 09:45:27,2023-04-25 12:07:38,Carrefour,-5.14,0.00,EUR,COMPLETED,3431.39
CARD_PAYMENT,Current,2023-04-25 09:58:46,2023-04-26 13:37:45,Esselunga,-17.33,0.00,EUR,COMPLETED,3414.06
CARD_PAYMENT,Current,2023-04-27 20:01:31,2023-04-28 15:09:49,Esselunga,-11.05,0.00,EUR,COMPLETED,3403.01
CARD_PAYMENT,Current,2023-04-28 19:48:53,2023-04-29 15:52:19,Esselunga,-6.52,0.00,EUR,COMPLETED,3396.49
CARD_PAYMENT,Current,2023-04-29 09:00:36,2023-05-03 11:20:38,Lavanderia Huang Haifeng,-3.00,0.00,EUR,COMPLETED,3393.49
CARD_PAYMENT,Current,2023-05-02 19:19:21,2023-05-03 16:51:56,Esselunga,-2.69,0.00,EUR,COMPLETED,3390.80
CARD_PAYMENT,Current,2023-05-02 13:31:17,2023-05-03 17:06:41,Politecnico Leonardo,-5.50,0.00,EUR,COMPLETED,3385.30
CARD_PAYMENT,Current,2023-05-03 12:55:33,2023-05-04 11:45:37,Tailor food'n kitchen Pellegrini Bovisa,-6.50,0.00,EUR,COMPLETED,3378.80
CARD_PAYMENT,Current,2023-05-04 09:32:06,2023-05-05 11:32:37,Bikemi,-12.00,0.00,EUR,COMPLETED,3366.80
CARD_PAYMENT,Current,2023-05-04 12:47:34,2023-05-05 11:57:03,Tailor food'n kitchen Pellegrini Bovisa,-6.30,0.00,EUR,COMPLETED,3360.50
CARD_PAYMENT,Current,2023-05-05 13:12:20,2023-05-06 16:16:16,Politecnico di Milano,-7.00,0.00,EUR,COMPLETED,3353.50
CARD_PAYMENT,Current,2023-05-06 13:15:00,2023-05-07 12:28:15,Re Sole,-7.00,0.00,EUR,COMPLETED,3346.50
CARD_PAYMENT,Current,2023-05-06 11:30:59,2023-05-08 13:00:26,Esselunga,-15.52,0.00,EUR,COMPLETED,3330.98
CARD_PAYMENT,Current,2023-05-06 13:12:09,2023-05-09 10:53:14,Lloyds Farmacia,-14.20,0.00,EUR,COMPLETED,3316.78
CARD_PAYMENT,Current,2023-05-08 13:13:27,2023-05-09 14:31:31,Politecnico di Milano,-7.00,0.00,EUR,COMPLETED,3309.78
CARD_PAYMENT,Current,2023-05-09 20:19:38,2023-05-10 13:49:18,Carrefour,-11.49,0.00,EUR,COMPLETED,3298.29
CARD_PAYMENT,Current,2023-05-09 19:28:58,2023-05-10 15:42:08,Diva Parrucchiere,-12.00,0.00,EUR,COMPLETED,3286.29
CARD_PAYMENT,Current,2023-05-10 08:37:41,2023-05-11 14:30:10,Carrefour,-15.99,0.00,EUR,COMPLETED,3270.30
CARD_PAYMENT,Current,2023-05-10 12:39:37,2023-05-11 15:12:17,Politecnico di Milano,-7.00,0.00,EUR,COMPLETED,3263.30
CARD_PAYMENT,Current,2023-05-10 12:40:12,2023-05-11 15:12:18,Politecnico di Milano,-55.00,0.00,EUR,COMPLETED,3208.30
CARD_PAYMENT,Current,2023-05-11 09:24:08,2023-05-12 17:23:17,Pasticceria I 4 Mastr..,-3.00,0.00,EUR,COMPLETED,3205.30
CARD_PAYMENT,Current,2023-05-12 09:30:35,2023-05-13 13:24:51,Esselunga,-22.15,0.00,EUR,COMPLETED,3183.15
CARD_PAYMENT,Current,2023-05-12 20:10:31,2023-05-13 13:25:14,Esselunga,-35.26,0.00,EUR,COMPLETED,3147.89
CARD_PAYMENT,Current,2023-05-14 11:45:23,2023-05-15 13:04:05,Carrefour,-15.42,0.00,EUR,COMPLETED,3132.47
CARD_PAYMENT,Current,2023-05-14 12:01:34,2023-05-15 13:24:13,Esselunga,-2.94,0.00,EUR,COMPLETED,3129.53
CARD_PAYMENT,Current,2023-05-17 13:17:30,2023-05-18 14:39:57,Politecnico di Milano,-7.00,0.00,EUR,COMPLETED,3122.53
CARD_PAYMENT,Current,2023-05-18 13:04:47,2023-05-19 14:36:50,Politecnico di Milano,-7.00,0.00,EUR,COMPLETED,3115.53
CARD_PAYMENT,Current,2023-05-18 13:50:19,2023-05-19 14:37:40,A2A Energia,-128.00,0.00,EUR,COMPLETED,2987.53
CARD_PAYMENT,Current,2023-05-19 13:16:11,2023-05-20 12:57:00,Politecnico di Milano,-7.00,0.00,EUR,COMPLETED,2980.53
CARD_PAYMENT,Current,2023-05-21 11:02:36,2023-05-22 12:35:22,Esselunga,-5.98,0.00,EUR,COMPLETED,2974.55
CARD_PAYMENT,Current,2023-05-23 08:17:26,2023-05-25 11:08:10,Asst Fatebenefratelli Sac,-8.35,0.00,EUR,COMPLETED,2966.20
CARD_PAYMENT,Current,2023-05-24 12:43:32,2023-05-25 12:13:34,Politecnico Leonardo,-7.00,0.00,EUR,COMPLETED,2959.20
CARD_PAYMENT,Current,2023-05-25 20:45:30,2023-05-26 15:33:10,Carrefour,-11.97,0.00,EUR,COMPLETED,2947.23
CARD_PAYMENT,Current,2023-05-28 10:31:12,2023-05-29 12:36:13,Esselunga,-23.23,0.00,EUR,COMPLETED,2924.00
CARD_PAYMENT,Current,2023-05-27 13:19:49,2023-05-29 12:43:12,Pizzalandia Due,-6.50,0.00,EUR,COMPLETED,2917.50
CARD_PAYMENT,Current,2023-05-27 07:40:14,2023-05-30 10:15:32,Farmacia Ambreck,-13.90,0.00,EUR,COMPLETED,2903.60
CARD_PAYMENT,Current,2023-05-30 20:52:39,2023-05-31 12:36:40,Carrefour,-12.47,0.00,EUR,COMPLETED,2891.13
CARD_PAYMENT,Current,2023-05-30 13:08:52,2023-05-31 12:55:52,Politecnico Leonardo,-7.00,0.00,EUR,COMPLETED,2884.13
CARD_PAYMENT,Current,2023-05-31 12:53:14,2023-06-01 20:09:26,Farmacia Leoncavallo,-7.00,0.00,EUR,COMPLETED,2877.13
CARD_PAYMENT,Current,2023-06-01 12:49:06,2023-06-03 20:16:09,Politecnico di Milano,-7.00,0.00,EUR,COMPLETED,2870.13
CARD_PAYMENT,Current,2023-06-04 16:13:28,2023-06-05 11:53:29,Carrefour,-15.74,0.00,EUR,COMPLETED,2854.39
CARD_PAYMENT,Current,2023-06-04 11:46:11,2023-06-05 12:49:06,Esselunga,-5.62,0.00,EUR,COMPLETED,2848.77
CARD_PAYMENT,Current,2023-06-05 16:20:49,2023-06-06 11:56:33,iliad,-15.00,0.00,EUR,COMPLETED,2833.77
CARD_PAYMENT,Current,2023-06-06 13:30:50,2023-06-07 18:19:43,Politecnico di Milano,-7.00,0.00,EUR,COMPLETED,2826.77
CARD_PAYMENT,Current,2023-06-07 12:21:47,2023-06-08 12:49:45,Politecnico di Milano,-7.00,0.00,EUR,COMPLETED,2819.77
CARD_PAYMENT,Current,2023-06-08 12:51:33,2023-06-09 17:15:47,Politecnico di Milano,-7.00,0.00,EUR,COMPLETED,2812.77
CARD_PAYMENT,Current,2023-06-09 09:15:15,2023-06-10 14:00:21,Esselunga,-2.99,0.00,EUR,COMPLETED,2809.78
CARD_PAYMENT,Current,2023-06-09 09:18:50,2023-06-11 11:34:38,Panificio Pasticceria,-4.70,0.00,EUR,COMPLETED,2805.08
CARD_PAYMENT,Current,2023-06-10 14:49:08,2023-06-11 15:58:56,La Cuccuma,-12.45,0.00,EUR,COMPLETED,2792.63
CARD_PAYMENT,Current,2023-06-10 09:11:13,2023-06-11 17:41:22,Vivi,-1.50,0.00,EUR,COMPLETED,2791.13
CARD_PAYMENT,Current,2023-06-11 19:10:16,2023-06-12 13:36:56,Carrefour,-10.99,0.00,EUR,COMPLETED,2780.14
CARD_PAYMENT,Current,2023-06-10 19:52:28,2023-06-12 13:59:17,Esselunga,-8.64,0.00,EUR,COMPLETED,2771.50
CARD_PAYMENT,Current,2023-06-11 12:54:09,2023-06-12 14:01:28,Pam Panorama,-4.04,0.00,EUR,COMPLETED,2767.46
CARD_PAYMENT,Current,2023-06-12 18:26:53,2023-06-14 10:34:07,Gelateria la Nuova Cascina,-2.80,0.00,EUR,COMPLETED,2764.66
CARD_PAYMENT,Current,2023-06-13 10:09:24,2023-06-14 12:44:27,Esselunga,-8.23,0.00,EUR,COMPLETED,2756.43
CARD_PAYMENT,Current,2023-06-14 12:44:18,2023-06-15 14:17:01,Politecnico di Milano,-7.00,0.00,EUR,COMPLETED,2749.43
CARD_PAYMENT,Current,2023-06-15 19:39:04,2023-06-16 13:15:22,Carrefour,-10.59,0.00,EUR,COMPLETED,2738.84
CARD_PAYMENT,Current,2023-06-16 09:52:11,2023-06-17 20:03:30,Esselunga,-6.36,0.00,EUR,COMPLETED,2732.48
CARD_PAYMENT,Current,2023-06-18 12:51:44,2023-06-19 13:19:19,Esselunga,-28.91,0.00,EUR,COMPLETED,2703.57
CARD_PAYMENT,Current,2023-06-17 12:23:13,2023-06-19 13:24:44,Pizzalandia Due,-6.50,0.00,EUR,COMPLETED,2697.07
CARD_PAYMENT,Current,2023-06-19 13:57:57,2023-06-20 13:48:52,Vodafone,-1.30,0.00,EUR,COMPLETED,2695.77
CARD_PAYMENT,Current,2023-06-19 22:22:29,2023-06-20 13:53:10,Omi,-18.00,0.00,EUR,COMPLETED,2677.77
TRANSFER,Current,2023-06-20 17:40:03,2023-06-20 17:40:03,To NICOLA TUMMOLO,-5.00,0.00,EUR,COMPLETED,2672.77
CARD_PAYMENT,Current,2023-06-20 19:12:39,2023-06-21 12:25:16,Farmacia Calo Del Dr. C,-3.50,0.00,EUR,COMPLETED,2669.27
CARD_PAYMENT,Current,2023-06-21 14:21:43,2023-06-22 13:00:20,laESSE,-6.44,0.00,EUR,COMPLETED,2662.83
CARD_PAYMENT,Current,2023-06-22 12:48:24,2023-06-23 11:53:41,Tailor food'n kitchen Pellegrini Bovisa,-6.30,0.00,EUR,COMPLETED,2656.53
CARD_PAYMENT,Current,2023-06-23 12:39:01,2023-06-24 12:01:56,I Baccala Le,-7.00,0.00,EUR,COMPLETED,2649.53
CARD_PAYMENT,Current,2023-06-24 20:09:55,2023-06-26 12:38:52,Carrefour,-11.75,0.00,EUR,COMPLETED,2637.78
CARD_PAYMENT,Current,2023-06-24 12:46:26,2023-06-26 12:54:55,Pam Panorama,-6.18,0.00,EUR,COMPLETED,2631.60
CARD_PAYMENT,Current,2023-06-26 20:35:09,2023-06-27 12:11:45,Carrefour,-19.08,0.00,EUR,COMPLETED,2612.52
CARD_PAYMENT,Current,2023-06-26 12:25:43,2023-06-27 12:26:16,Politecnico di Milano,-7.00,0.00,EUR,COMPLETED,2605.52
CARD_PAYMENT,Current,2023-06-26 19:35:32,2023-06-27 13:23:00,Diva Parrucchiere,-12.00,0.00,EUR,COMPLETED,2593.52
CARD_PAYMENT,Current,2023-06-26 07:53:42,2023-06-28 10:31:20,Jolly Student Food,-1.20,0.00,EUR,COMPLETED,2592.32
CARD_PAYMENT,Current,2023-06-27 17:29:30,2023-06-28 12:16:55,Carrefour,-3.10,0.00,EUR,COMPLETED,2589.22
CARD_PAYMENT,Current,2023-06-27 12:33:42,2023-06-28 12:33:59,Politecnico di Milano,-7.00,0.00,EUR,COMPLETED,2582.22
CARD_PAYMENT,Current,2023-06-28 20:01:02,2023-06-29 16:43:11,Esselunga,-10.36,0.00,EUR,COMPLETED,2571.86
CARD_PAYMENT,Current,2023-06-29 18:57:09,2023-06-30 11:23:36,H&M,-25.18,0.00,EUR,COMPLETED,2546.68
CARD_PAYMENT,Current,2023-06-29 12:39:57,2023-06-30 12:25:11,I Baccala Le,-7.00,0.00,EUR,COMPLETED,2539.68
CARD_PAYMENT,Current,2023-06-30 12:19:47,2023-07-01 13:47:38,Politecnico di Milano,-5.50,0.00,EUR,COMPLETED,2534.18
CARD_PAYMENT,Current,2023-07-02 18:42:10,2023-07-03 11:02:41,PittaRosso,-50.19,0.00,EUR,COMPLETED,2483.99
CARD_PAYMENT,Current,2023-07-01 12:28:48,2023-07-03 16:27:58,Esselunga,-7.14,0.00,EUR,COMPLETED,2476.85
CARD_PAYMENT,Current,2023-07-01 18:15:04,2023-07-03 16:27:58,Esselunga,-4.07,0.00,EUR,COMPLETED,2472.78
CARD_PAYMENT,Current,2023-07-02 19:43:55,2023-07-03 16:29:11,Terranova,-63.10,0.00,EUR,COMPLETED,2409.68
CARD_PAYMENT,Current,2023-07-01 17:37:20,2023-07-04 11:14:08,Mech,-25.00,0.00,EUR,COMPLETED,2384.68
CARD_PAYMENT,Current,2023-07-02 13:26:46,2023-07-04 11:14:08,Bigoni Elio Benedetto,-2.70,0.00,EUR,COMPLETED,2381.98
CARD_PAYMENT,Current,2023-07-03 13:16:27,2023-07-04 13:22:27,Long Yuan Rosticceria,-6.00,0.00,EUR,COMPLETED,2375.98
CARD_PAYMENT,Current,2023-07-04 02:51:53,2023-07-05 11:59:09,iliad,-9.99,0.00,EUR,COMPLETED,2365.99
CARD_PAYMENT,Current,2023-07-04 08:01:34,2023-07-05 12:28:34,Esselunga,-1.05,0.00,EUR,COMPLETED,2364.94
CARD_PAYMENT,Current,2023-07-04 13:49:43,2023-07-05 12:29:17,Pam Panorama,-2.00,0.00,EUR,COMPLETED,2362.94
CARD_PAYMENT,Current,2023-07-05 14:09:07,2023-07-06 12:50:26,Don Raffaele,-9.00,0.00,EUR,COMPLETED,2353.94
TRANSFER,Current,2023-07-07 08:16:07,2023-07-07 08:16:10,To Stock House Sas,-575.00,0.00,EUR,COMPLETED,1778.94
CARD_PAYMENT,Current,2023-07-06 13:05:58,2023-07-07 16:34:23,Pam Panorama,-3.29,0.00,EUR,COMPLETED,1775.65
CARD_PAYMENT,Current,2023-07-07 09:35:56,2023-07-08 16:40:50,Italian Bakery,-2.20,0.00,EUR,COMPLETED,1773.45
CARD_PAYMENT,Current,2023-07-07 14:02:31,2023-07-09 10:58:47,Banana Mama,-6.00,0.00,EUR,COMPLETED,1767.45
CARD_PAYMENT,Current,2023-07-08 08:24:43,2023-07-10 11:37:17,Carrefour,-2.62,0.00,EUR,COMPLETED,1764.83
CARD_PAYMENT,Current,2023-07-08 13:34:04,2023-07-10 11:37:17,Carrefour,-7.03,0.00,EUR,COMPLETED,1757.80
CARD_PAYMENT,Current,2023-07-09 20:19:55,2023-07-10 12:30:06,Re Sole,-8.00,0.00,EUR,COMPLETED,1749.80
CARD_PAYMENT,Current,2023-07-10 21:49:11,2023-07-11 15:08:48,Mozzarella e Basilico,-11.33,0.00,EUR,COMPLETED,1738.47
CARD_PAYMENT,Current,2023-07-10 10:29:29,2023-07-12 11:22:29,Trenitalia,-53.20,0.00,EUR,COMPLETED,1685.27
CARD_PAYMENT,Current,2023-07-11 12:32:24,2023-07-12 15:41:21,Esselunga,-9.12,0.00,EUR,COMPLETED,1676.15
CARD_PAYMENT,Current,2023-07-12 14:09:57,2023-07-13 15:16:40,Ristorante Da Trap,-13.00,0.00,EUR,COMPLETED,1663.15
CARD_PAYMENT,Current,2023-07-13 19:21:26,2023-07-14 16:45:54,Esselunga,-9.49,0.00,EUR,COMPLETED,1653.66
CARD_PAYMENT,Current,2023-07-13 18:35:13,2023-07-14 16:46:34,Terranova,-24.15,0.00,EUR,COMPLETED,1629.51
CARD_PAYMENT,Current,2023-07-13 10:00:32,2023-07-14 17:15:44,Italian Bakery,-1.50,0.00,EUR,COMPLETED,1628.01
CARD_PAYMENT,Current,2023-07-14 20:58:59,2023-07-15 11:32:20,Soul Kitchensoul Kitchen,-6.00,0.00,EUR,COMPLETED,1622.01
CARD_PAYMENT,Current,2023-07-13 13:52:06,2023-07-15 12:48:42,Moon Light 92,-10.00,0.00,EUR,COMPLETED,1612.01
CARD_PAYMENT,Current,2023-07-14 17:06:26,2023-07-15 20:11:52,Pam Panorama,-2.10,0.00,EUR,COMPLETED,1609.91
CARD_PAYMENT,Current,2023-07-14 12:54:27,2023-07-15 20:38:15,Geru Milano Cafe',-3.50,0.00,EUR,COMPLETED,1606.41
ATM,Current,2023-07-16 18:35:40,2023-07-17 11:53:47,Cash at Atm Mestre Fs,-20.00,0.00,EUR,COMPLETED,1586.41
ATM,Current,2023-07-16 18:39:08,2023-07-17 11:53:47,Cash at Atm Mestre Fs,-40.00,0.00,EUR,COMPLETED,1546.41
CARD_PAYMENT,Current,2023-07-17 13:00:36,2023-07-18 17:02:35,Pam Panorama,-2.57,0.00,EUR,COMPLETED,1543.84
CARD_PAYMENT,Current,2023-07-17 18:31:44,2023-07-19 10:42:56,Kasanova,-9.90,0.00,EUR,COMPLETED,1533.94
CARD_PAYMENT,Current,2023-07-18 14:00:30,2023-07-19 17:51:10,Pizzootto Gusto All'infi,-13.50,0.00,EUR,COMPLETED,1520.44
CARD_PAYMENT,Current,2023-07-18 20:55:57,2023-07-20 10:27:38,Trenitalia,-29.00,0.00,EUR,COMPLETED,1491.44
CARD_PAYMENT,Current,2023-07-19 13:08:38,2023-07-20 13:53:41,Politecnico di Milano,-7.00,0.00,EUR,COMPLETED,1484.44
CARD_PAYMENT,Current,2023-07-20 18:29:29,2023-07-21 13:45:04,Tannico,-45.45,0.00,EUR,COMPLETED,1438.99
CARD_PAYMENT,Current,2023-07-20 12:58:30,2023-07-21 20:10:03,Pam Panorama,-7.20,0.00,EUR,COMPLETED,1431.79
CARD_PAYMENT,Current,2023-07-20 12:06:34,2023-07-21 20:14:19,Odontoiatrica S. Michele,-29.00,0.00,EUR,COMPLETED,1402.79
CARD_PAYMENT,Current,2023-07-20 16:51:55,2023-07-21 20:16:52,laESSE,-2.98,0.00,EUR,COMPLETED,1399.81
CARD_PAYMENT,Current,2023-07-21 16:12:58,2023-07-22 13:45:17,Too Good To Go,-2.99,0.00,EUR,COMPLETED,1396.82
CARD_PAYMENT,Current,2023-07-21 20:58:06,2023-07-22 20:15:50,Quanto Basta,-7.60,0.00,EUR,COMPLETED,1389.22
CARD_PAYMENT,Current,2023-07-23 12:03:09,2023-07-25 10:28:47,Gelato,-20.00,0.00,EUR,COMPLETED,1369.22
CARD_PAYMENT,Current,2023-07-25 19:33:22,2023-07-26 15:19:02,Esselunga,-17.64,0.00,EUR,COMPLETED,1351.58
CARD_PAYMENT,Current,2023-07-25 13:10:51,2023-07-26 15:43:06,Oven Srl A Socio Unic..,-5.50,0.00,EUR,COMPLETED,1346.08
CARD_PAYMENT,Current,2023-07-26 22:06:06,2023-07-27 16:14:46,Pan Xiaomiao,-22.50,0.00,EUR,COMPLETED,1323.58
CARD_PAYMENT,Current,2023-07-26 14:07:36,2023-07-28 11:59:56,Moon Light 92,-8.00,0.00,EUR,COMPLETED,1315.58
CARD_PAYMENT,Current,2023-07-27 11:19:06,2023-07-28 19:51:24,Esselunga,-9.56,0.00,EUR,COMPLETED,1306.02
CARD_PAYMENT,Current,2023-07-28 19:27:38,2023-07-29 16:04:51,Esselunga,-9.26,0.00,EUR,COMPLETED,1296.76
CARD_PAYMENT,Current,2023-07-30 17:09:39,2023-07-31 11:21:17,Golconda Gelati,-4.00,0.00,EUR,COMPLETED,1292.76
CARD_PAYMENT,Current,2023-07-31 13:21:24,2023-08-01 18:52:45,Pam Panorama,-4.00,0.00,EUR,COMPLETED,1288.76
CARD_PAYMENT,Current,2023-08-01 14:03:18,2023-08-02 16:30:11,Don Raffaele,-8.00,0.00,EUR,COMPLETED,1280.76
CARD_PAYMENT,Current,2023-08-02 13:46:11,2023-08-03 15:53:04,Esselunga,-17.08,0.00,EUR,COMPLETED,1263.68
CARD_PAYMENT,Current,2023-08-04 03:01:22,2023-08-05 16:03:39,iliad,-9.99,0.00,EUR,COMPLETED,1253.69
CARD_PAYMENT,Current,2023-08-05 17:44:29,2023-08-07 10:33:14,Il Gelatone,-8.50,0.00,EUR,COMPLETED,1245.19
CARD_PAYMENT,Current,2023-08-13 18:22:40,2023-08-14 12:06:23,Gelateria Nonnamica,-18.00,0.00,EUR,COMPLETED,1227.19
CARD_PAYMENT,Current,2023-08-14 20:00:49,2023-08-16 15:02:14,Esselunga,-8.07,0.00,EUR,COMPLETED,1219.12
CARD_PAYMENT,Current,2023-08-16 18:52:24,2023-08-17 18:17:46,Carrefour,-6.37,0.00,EUR,COMPLETED,1212.75
CARD_PAYMENT,Current,2023-08-16 12:28:30,2023-08-17 18:17:46,Carrefour,-2.29,0.00,EUR,COMPLETED,1210.46
CARD_PAYMENT,Current,2023-08-17 13:05:35,2023-08-18 15:48:55,Carrefour,-8.13,0.00,EUR,COMPLETED,1202.33
CARD_PAYMENT,Current,2023-08-18 16:48:02,2023-08-19 19:41:37,Esselunga,-15.06,0.00,EUR,COMPLETED,1187.27
CARD_PAYMENT,Current,2023-08-19 13:02:03,2023-08-21 11:23:25,Carrefour,-5.55,0.00,EUR,COMPLETED,1181.72
CARD_PAYMENT,Current,2023-08-20 11:47:25,2023-08-21 11:57:19,Esselunga,-10.07,0.00,EUR,COMPLETED,1171.65
ATM,Current,2023-08-22 14:24:45,2023-08-24 11:34:39,Cash at Via Edoardo Bonardi 4,-30.00,0.00,EUR,COMPLETED,1141.65
CARD_PAYMENT,Current,2023-08-26 22:13:37,2023-08-27 19:59:00,Pizzium Spa Viale And..,-17.00,0.00,EUR,COMPLETED,1124.65
CARD_PAYMENT,Current,2023-08-28 08:30:39,2023-08-29 17:02:01,Carrefour,-3.79,0.00,EUR,COMPLETED,1120.86
TOPUP,Current,2023-08-30 09:09:17,2023-08-30 09:09:17,Payment from Stripe,594.80,0.00,EUR,COMPLETED,1715.66
CARD_PAYMENT,Current,2023-08-29 22:44:43,2023-08-30 11:14:03,pagoPA,-166.54,0.00,EUR,COMPLETED,1549.12
CARD_PAYMENT,Current,2023-08-29 22:56:18,2023-08-30 12:58:54,A2A Energia,-52.00,0.00,EUR,COMPLETED,1497.12
CARD_PAYMENT,Current,2023-08-31 12:52:12,2023-09-01 15:37:21,Esselunga,-10.32,0.00,EUR,COMPLETED,1486.80
TRANSFER,Current,2023-09-01 19:52:11,2023-09-01 19:52:13,To Gabriele Tonello,-74.80,0.00,EUR,COMPLETED,1412.00
CARD_PAYMENT,Current,2023-09-01 19:14:40,2023-09-02 12:59:50,Diva Parrucchiere,-12.00,0.00,EUR,COMPLETED,1400.00
TOPUP,Current,2023-09-04 09:29:24,2023-09-04 09:29:24,Payment from Stripe,460.36,0.00,EUR,COMPLETED,1860.36
TOPUP,Current,2023-09-05 08:48:40,2023-09-05 08:48:41,Payment from Stripe,752.95,0.00,EUR,COMPLETED,2613.31
CARD_PAYMENT,Current,2023-09-04 03:24:41,2023-09-05 14:40:00,iliad,-9.99,0.00,EUR,COMPLETED,2603.32
TOPUP,Current,2023-09-06 08:17:32,2023-09-06 08:17:32,Payment from Stripe,675.48,0.00,EUR,COMPLETED,3278.80
CARD_PAYMENT,Current,2023-09-05 13:07:48,2023-09-06 17:52:24,Politecnico di Milano,-2.10,0.00,EUR,COMPLETED,3276.70
CARD_PAYMENT,Current,2023-09-06 10:40:56,2023-09-07 17:12:54,Consolato Generale E Cen,-80.00,0.00,EUR,COMPLETED,3196.70
CARD_PAYMENT,Current,2023-09-10 18:33:36,2023-09-11 12:50:17,Terranova,-53.15,0.00,EUR,COMPLETED,3143.55
CARD_PAYMENT,Current,2023-09-10 19:11:08,2023-09-11 13:05:46,Just In Case,-34.99,0.00,EUR,COMPLETED,3108.56
TOPUP,Current,2023-09-13 08:23:00,2023-09-13 08:23:01,Payment from Stripe,254.19,0.00,EUR,COMPLETED,3362.75
TOPUP,Current,2023-09-14 08:18:31,2023-09-14 08:18:31,Payment from Stripe,254.19,0.00,EUR,COMPLETED,3616.94
TOPUP,Current,2023-09-15 09:13:22,2023-09-15 09:13:23,Payment from Stripe,254.19,0.00,EUR,COMPLETED,3871.13
CARD_PAYMENT,Current,2023-09-14 13:28:54,2023-09-15 16:34:20,Carrefour,-2.29,0.00,EUR,COMPLETED,3868.84
CARD_PAYMENT,Current,2023-09-14 20:44:05,2023-09-15 16:34:20,Carrefour,-10.20,0.00,EUR,COMPLETED,3858.64
TOPUP,Current,2023-09-18 09:25:38,2023-09-18 09:25:38,Payment from Stripe,316.60,0.00,EUR,COMPLETED,4175.24
CARD_PAYMENT,Current,2023-09-16 12:40:15,2023-09-18 12:26:53,Carrefour,-2.50,0.00,EUR,COMPLETED,4172.74
CARD_PAYMENT,Current,2023-09-17 13:43:40,2023-09-18 12:26:53,Carrefour,-6.99,0.00,EUR,COMPLETED,4165.75
CARD_PAYMENT,Current,2023-09-16 17:25:29,2023-09-18 12:26:53,Carrefour,-1.45,0.00,EUR,COMPLETED,4164.30
CARD_PAYMENT,Current,2023-09-16 19:31:51,2023-09-18 12:26:53,Carrefour,-14.13,0.00,EUR,COMPLETED,4150.17
TOPUP,Current,2023-09-19 08:48:40,2023-09-19 08:48:40,Payment from Stripe,254.19,0.00,EUR,COMPLETED,4404.36
CARD_PAYMENT,Current,2023-09-18 11:19:15,2023-09-19 13:35:45,Carrefour,-2.50,0.00,EUR,COMPLETED,4401.86
TOPUP,Current,2023-09-20 08:12:26,2023-09-20 08:12:26,Payment from Stripe,489.47,0.00,EUR,COMPLETED,4891.33
CARD_PAYMENT,Current,2023-09-19 13:22:01,2023-09-20 17:06:03,Politecnico di Milano,-1.71,0.00,EUR,COMPLETED,4889.62
CARD_PAYMENT,Current,2023-09-19 19:08:59,2023-09-21 10:48:08,Gelateria Rembrandt,-2.80,0.00,EUR,COMPLETED,4886.82
CARD_PAYMENT,Current,2023-09-20 19:36:34,2023-09-21 13:56:37,Pam Panorama,-4.00,0.00,EUR,COMPLETED,4882.82
CARD_PAYMENT,Current,2023-09-20 12:57:33,2023-09-21 14:07:10,Politecnico di Milano,-7.00,0.00,EUR,COMPLETED,4875.82
TRANSFER,Current,2023-09-22 09:19:45,2023-09-22 10:39:20,To Giacomo Giacinto Ghindinelli,-70.00,0.00,EUR,COMPLETED,4805.82
CARD_PAYMENT,Current,2023-09-21 12:59:35,2023-09-22 19:34:18,Esselunga,-10.55,0.00,EUR,COMPLETED,4795.27
CARD_PAYMENT,Current,2023-09-22 20:07:40,2023-09-23 12:18:06,Esselunga,-17.93,0.00,EUR,COMPLETED,4777.34
CARD_PAYMENT,Current,2023-09-22 13:03:16,2023-09-23 12:28:08,Politecnico Leonardo,-7.00,0.00,EUR,COMPLETED,4770.34
CARD_PAYMENT,Current,2023-09-21 13:02:36,2023-09-23 12:48:01,Panificio Pasticceria,-5.50,0.00,EUR,COMPLETED,4764.84
CARD_PAYMENT,Current,2023-09-24 14:52:25,2023-09-25 12:52:53,Carrefour,-2.79,0.00,EUR,COMPLETED,4762.05
CARD_PAYMENT,Current,2023-09-23 13:42:10,2023-09-25 12:52:53,Carrefour,-2.50,0.00,EUR,COMPLETED,4759.55
CARD_PAYMENT,Current,2023-09-24 19:37:27,2023-09-25 12:52:53,Carrefour,-16.03,0.00,EUR,COMPLETED,4743.52
CARD_PAYMENT,Current,2023-09-23 19:50:03,2023-09-26 11:28:03,Panificio Pasticceria,-8.40,0.00,EUR,COMPLETED,4735.12
CARD_PAYMENT,Current,2023-09-26 20:19:35,2023-09-27 12:36:50,Carrefour,-9.64,0.00,EUR,COMPLETED,4725.48
CARD_PAYMENT,Current,2023-09-26 13:28:07,2023-09-27 16:15:53,Politecnico Leonardo,-5.00,0.00,EUR,COMPLETED,4720.48
CARD_PAYMENT,Current,2023-09-27 12:58:07,2023-09-28 18:19:17,Esselunga,-12.07,0.00,EUR,COMPLETED,4708.41
CARD_PAYMENT,Current,2023-09-28 13:03:00,2023-09-29 11:07:02,Esselunga,-15.15,0.00,EUR,COMPLETED,4693.26
CARD_PAYMENT,Current,2023-09-27 12:49:13,2023-09-29 11:40:23,Kasanova,-36.10,0.00,EUR,COMPLETED,4657.16
CARD_PAYMENT,Current,2023-09-27 12:39:53,2023-09-29 11:40:24,Flli Cassetta,-10.50,0.00,EUR,COMPLETED,4646.66
CARD_PAYMENT,Current,2023-09-28 18:24:52,2023-09-29 13:36:29,La Milano Colo,-28.00,0.00,EUR,COMPLETED,4618.66
CARD_PAYMENT,Current,2023-09-28 18:37:15,2023-09-29 13:46:47,Elettromorgantini,-79.00,0.00,EUR,COMPLETED,4539.66
CARD_PAYMENT,Current,2023-09-29 13:05:08,2023-09-30 12:41:24,Politecnico di Milano,-5.50,0.00,EUR,COMPLETED,4534.16
CARD_PAYMENT,Current,2023-09-29 21:28:58,2023-10-01 03:41:17,Gelateria Rembrandt,-8.50,0.00,EUR,COMPLETED,4525.66
CARD_PAYMENT,Current,2023-09-30 14:10:26,2023-10-01 19:15:35,Esselunga,-5.37,0.00,EUR,COMPLETED,4520.29
CARD_PAYMENT,Current,2023-10-01 18:26:05,2023-10-02 13:13:28,Carrefour,-6.40,0.00,EUR,COMPLETED,4513.89
CARD_PAYMENT,Current,2023-10-01 12:59:15,2023-10-02 13:13:28,Carrefour,-6.50,0.00,EUR,COMPLETED,4507.39
CARD_PAYMENT,Current,2023-09-30 14:13:19,2023-10-03 12:31:57,Panificio Pasticceria,-14.20,0.00,EUR,COMPLETED,4493.19
CARD_PAYMENT,Current,2023-10-02 09:25:41,2023-10-03 13:32:00,Pellegrini Horse Butcher Shop,-1.00,0.00,EUR,COMPLETED,4492.19
CARD_PAYMENT,Current,2023-10-02 20:29:31,2023-10-03 16:39:40,Matricola Pub,-4.00,0.00,EUR,COMPLETED,4488.19
CARD_PAYMENT,Current,2023-10-03 20:36:56,2023-10-04 18:45:31,Esselunga,-4.24,0.00,EUR,COMPLETED,4483.95
CARD_PAYMENT,Current,2023-10-03 13:25:22,2023-10-04 18:55:55,Politecnico di Milano,-7.40,0.00,EUR,COMPLETED,4476.55
TOPUP,Current,2023-10-05 08:54:21,2023-10-05 08:54:21,Payment from Stripe,532.38,0.00,EUR,COMPLETED,5008.93
CARD_PAYMENT,Current,2023-10-04 19:00:35,2023-10-05 10:32:17,Esselunga,-1.43,0.00,EUR,COMPLETED,5007.50
CARD_PAYMENT,Current,2023-10-04 02:42:45,2023-10-05 15:55:01,iliad,-9.99,0.00,EUR,COMPLETED,4997.51
CARD_PAYMENT,Current,2023-10-05 20:31:31,2023-10-06 11:02:39,Terranova,-16.25,0.00,EUR,COMPLETED,4981.26
CARD_PAYMENT,Current,2023-10-04 13:05:31,2023-10-06 12:26:47,Panificio Pasticceria,-7.00,0.00,EUR,COMPLETED,4974.26
CARD_PAYMENT,Current,2023-10-05 18:57:41,2023-10-06 13:07:35,Venchi,-9.10,0.00,EUR,COMPLETED,4965.16
CARD_PAYMENT,Current,2023-10-06 21:02:19,2023-10-07 12:33:53,Mozzarella e Basilico,-39.00,0.00,EUR,COMPLETED,4926.16
CARD_PAYMENT,Current,2023-10-06 21:31:52,2023-10-07 13:51:33,Duomo di Milano,-4.40,0.00,EUR,COMPLETED,4921.76
CARD_PAYMENT,Current,2023-10-06 13:11:35,2023-10-07 14:03:00,Politecnico di Milano,-2.11,0.00,EUR,COMPLETED,4919.65
CARD_PAYMENT,Current,2023-10-06 21:18:38,2023-10-07 14:10:49,Venchi,-9.40,0.00,EUR,COMPLETED,4910.25
CARD_PAYMENT,Current,2023-10-08 12:41:01,2023-10-09 12:42:54,Esselunga,-10.71,0.00,EUR,COMPLETED,4899.54
CARD_PAYMENT,Current,2023-10-09 17:58:48,2023-10-10 10:36:04,Carrefour,-11.45,0.00,EUR,COMPLETED,4888.09
CARD_PAYMENT,Current,2023-10-09 11:15:59,2023-10-10 10:54:28,Rosso Salvatore,-6.00,0.00,EUR,COMPLETED,4882.09
CARD_PAYMENT,Current,2023-10-07 16:18:17,2023-10-10 12:50:30,Trenitalia,-20.80,0.00,EUR,COMPLETED,4861.29
CARD_PAYMENT,Current,2023-10-08 12:34:43,2023-10-10 12:50:30,Lloyds Farmacia,-12.10,0.00,EUR,COMPLETED,4849.19
CARD_PAYMENT,Current,2023-10-07 16:44:17,2023-10-10 12:50:30,Made In Italy Di Dell'acq,-2.40,0.00,EUR,COMPLETED,4846.79
CARD_PAYMENT,Current,2023-10-07 11:55:07,2023-10-10 12:50:30,Trenitalia,-20.80,0.00,EUR,COMPLETED,4825.99
TOPUP,Current,2023-10-12 08:49:44,2023-10-12 08:49:44,Payment from Stripe,254.19,0.00,EUR,COMPLETED,5080.18
CARD_PAYMENT,Current,2023-10-12 19:23:40,2023-10-13 19:13:57,Esselunga,-3.66,0.00,EUR,COMPLETED,5076.52
CARD_PAYMENT,Current,2023-10-13 13:07:12,2023-10-14 12:28:55,Politecnico di Milano,-2.11,0.00,EUR,COMPLETED,5074.41
CARD_PAYMENT,Current,2023-10-12 19:27:24,2023-10-14 14:52:14,Panificio Pasticceria,-9.70,0.00,EUR,COMPLETED,5064.71
CARD_PAYMENT,Current,2023-10-14 15:43:15,2023-10-15 14:15:51,Amazon,-20.99,0.00,EUR,COMPLETED,5043.72
CARD_PAYMENT,Current,2023-10-14 19:46:03,2023-10-16 10:35:40,Esselunga,-13.72,0.00,EUR,COMPLETED,5030.00
CARD_PAYMENT,Current,2023-10-15 12:51:30,2023-10-16 10:35:40,Esselunga,-13.66,0.00,EUR,COMPLETED,5016.34
CARD_PAYMENT,Current,2023-10-14 19:01:21,2023-10-16 10:40:44,Terranova,-34.95,0.00,EUR,COMPLETED,4981.39
CARD_PAYMENT,Current,2023-10-16 13:11:45,2023-10-17 12:27:18,Gustami,-4.30,0.00,EUR,COMPLETED,4977.09
CARD_PAYMENT,Current,2023-10-16 09:23:14,2023-10-17 12:27:18,Pellegrini Horse Butcher Shop,-2.40,0.00,EUR,COMPLETED,4974.69
CARD_PAYMENT,Current,2023-10-16 20:09:09,2023-10-17 14:27:34,Carrefour,-2.01,0.00,EUR,COMPLETED,4972.68
CARD_PAYMENT,Current,2023-10-17 13:21:18,2023-10-18 17:55:28,Politecnico Leonardo,-7.40,0.00,EUR,COMPLETED,4965.28
CARD_PAYMENT,Current,2023-10-17 17:53:59,2023-10-19 18:18:29,Amazon,-22.97,0.00,EUR,COMPLETED,4942.31
CARD_PAYMENT,Current,2023-10-18 19:01:02,2023-10-19 19:07:31,Esselunga,-13.97,0.00,EUR,COMPLETED,4928.34
CARD_PAYMENT,Current,2023-10-18 12:45:25,2023-10-20 11:52:13,Panificio Pasticceria,-10.60,0.00,EUR,COMPLETED,4917.74
CARD_PAYMENT,Current,2023-10-20 13:03:21,2023-10-21 12:06:56,Politecnico di Milano,-2.11,0.00,EUR,COMPLETED,4915.63
CARD_PAYMENT,Current,2023-10-20 19:54:03,2023-10-22 11:19:55,Panificio Pasticceria,-7.50,0.00,EUR,COMPLETED,4908.13
CARD_PAYMENT,Current,2023-10-21 21:34:20,2023-10-22 12:15:54,Re Sole,-8.00,0.00,EUR,COMPLETED,4900.13
TRANSFER,Current,2023-10-22 19:08:16,2023-10-22 19:08:18,To Gabriele Tonello,-100.00,0.00,EUR,COMPLETED,4800.13
TRANSFER,Current,2023-10-22 19:08:43,2023-10-22 19:08:44,To Gabriele Tonello,-100.00,0.00,EUR,COMPLETED,4700.13
CARD_PAYMENT,Current,2023-10-21 13:39:43,2023-10-23 13:42:33,Carrefour,-5.23,0.00,EUR,COMPLETED,4694.90
CARD_PAYMENT,Current,2023-10-22 13:29:26,2023-10-23 13:42:33,Carrefour,-4.97,0.00,EUR,COMPLETED,4689.93
CARD_PAYMENT,Current,2023-10-24 13:21:08,2023-10-25 15:19:57,Politecnico di Milano,-2.11,0.00,EUR,COMPLETED,4687.82
CARD_PAYMENT,Current,2023-10-25 20:31:34,2023-10-26 14:19:18,Carrefour,-10.38,0.00,EUR,COMPLETED,4677.44
CARD_PAYMENT,Current,2023-10-25 13:39:28,2023-10-26 14:43:34,Politecnico Leonardo,-7.40,0.00,EUR,COMPLETED,4670.04
CARD_PAYMENT,Current,2023-10-27 13:04:06,2023-10-28 11:36:17,Politecnico di Milano,-0.51,0.00,EUR,COMPLETED,4669.53
CARD_PAYMENT,Current,2023-10-26 19:40:11,2023-10-28 16:10:21,Panificio Pasticceria,-10.00,0.00,EUR,COMPLETED,4659.53
CARD_PAYMENT,Current,2023-10-27 20:17:56,2023-10-29 16:08:16,Gelateria Rembrandt,-8.50,0.00,EUR,COMPLETED,4651.03
CARD_PAYMENT,Current,2023-10-29 13:28:22,2023-10-30 11:11:57,Carrefour,-7.57,0.00,EUR,COMPLETED,4643.46
CARD_PAYMENT,Current,2023-10-28 13:16:52,2023-10-30 11:11:57,Carrefour,-3.44,0.00,EUR,COMPLETED,4640.02
CARD_PAYMENT,Current,2023-10-29 19:05:11,2023-10-30 11:11:57,Carrefour,-2.88,0.00,EUR,COMPLETED,4637.14
CARD_PAYMENT,Current,2023-10-30 20:02:02,2023-10-31 10:47:32,Carrefour,-4.53,0.00,EUR,COMPLETED,4632.61
CARD_PAYMENT,Current,2023-10-30 13:10:45,2023-10-31 12:26:22,Pellegrini Horse Butcher Shop,-6.90,0.00,EUR,COMPLETED,4625.71
CARD_PAYMENT,Current,2023-10-31 12:54:38,2023-11-01 10:59:14,Politecnico di Milano,-7.40,0.00,EUR,COMPLETED,4618.31
CARD_PAYMENT,Current,2023-10-31 15:30:50,2023-11-01 10:59:45,A2A Energia,-48.00,0.00,EUR,COMPLETED,4570.31
CARD_PAYMENT,Current,2023-10-31 16:32:37,2023-11-01 14:18:08,ATM - Azienda Trasporti Milanesi,-22.00,0.00,EUR,COMPLETED,4548.31
TOPUP,Current,2023-11-02 09:03:11,2023-11-02 09:03:12,Payment from Stripe,254.19,0.00,EUR,COMPLETED,4802.50
CARD_PAYMENT,Current,2023-11-01 11:51:44,2023-11-02 11:47:01,Carrefour,-4.11,0.00,EUR,COMPLETED,4798.39
CARD_PAYMENT,Current,2023-11-01 19:07:06,2023-11-02 16:54:13,Re Sole,-8.00,0.00,EUR,COMPLETED,4790.39
CARD_PAYMENT,Current,2023-11-01 19:02:36,2023-11-03 14:51:54,Esselunga,-13.05,0.00,EUR,COMPLETED,4777.34
CARD_PAYMENT,Current,2023-10-31 19:39:44,2023-11-03 15:13:56,Panificio Pasticceria,-10.00,0.00,EUR,COMPLETED,4767.34
CARD_PAYMENT,Current,2023-11-03 14:16:17,2023-11-04 12:17:14,Politecnico Leonardo,-6.00,0.00,EUR,COMPLETED,4761.34
CARD_PAYMENT,Current,2023-11-03 19:36:10,2023-11-05 10:50:16,Panificio Pasticceria,-6.70,0.00,EUR,COMPLETED,4754.64
CARD_PAYMENT,Current,2023-11-04 02:43:20,2023-11-05 12:27:34,iliad,-9.99,0.00,EUR,COMPLETED,4744.65
CARD_PAYMENT,Current,2023-11-05 13:29:36,2023-11-06 12:31:55,Carrefour,-6.78,0.00,EUR,COMPLETED,4737.87
CARD_PAYMENT,Current,2023-11-04 12:39:31,2023-11-06 12:31:55,Carrefour,-3.98,0.00,EUR,COMPLETED,4733.89
CARD_PAYMENT,Current,2023-11-04 18:29:30,2023-11-06 12:50:35,Esselunga,-9.46,0.00,EUR,COMPLETED,4724.43
CARD_PAYMENT,Current,2023-11-05 14:49:24,2023-11-06 13:03:04,Grecchi,-2.70,0.00,EUR,COMPLETED,4721.73
CARD_PAYMENT,Current,2023-11-05 09:25:31,2023-11-06 13:33:11,Spesa Comoda,-3.45,0.00,EUR,COMPLETED,4718.28
CARD_PAYMENT,Current,2023-11-06 13:10:42,2023-11-08 11:14:21,Panificio Pasticceria,-11.50,0.00,EUR,COMPLETED,4706.78
CARD_PAYMENT,Current,2023-11-08 13:11:37,2023-11-09 11:03:51,Politecnico di Milano,-2.11,0.00,EUR,COMPLETED,4704.67
CARD_PAYMENT,Current,2023-11-08 07:35:30,2023-11-09 12:17:05,Jolly Student Food,-2.80,0.00,EUR,COMPLETED,4701.87
CARD_PAYMENT,Current,2023-11-08 19:25:54,2023-11-10 13:04:09,Panificio Pasticceria,-5.50,0.00,EUR,COMPLETED,4696.37
CARD_PAYMENT,Current,2023-11-09 19:45:40,2023-11-11 14:32:24,Carrefour,-8.69,0.00,EUR,COMPLETED,4687.68
CARD_PAYMENT,Current,2023-11-10 13:14:45,2023-11-11 15:09:04,Politecnico di Milano,-7.40,0.00,EUR,COMPLETED,4680.28
CARD_PAYMENT,Current,2023-11-11 09:23:31,2023-11-12 11:37:48,Jolly Student Food,-2.80,0.00,EUR,COMPLETED,4677.48
CARD_PAYMENT,Current,2023-11-12 12:36:09,2023-11-13 10:56:52,Carrefour,-11.27,0.00,EUR,COMPLETED,4666.21
CARD_PAYMENT,Current,2023-11-11 19:41:52,2023-11-13 10:56:52,Carrefour,-13.65,0.00,EUR,COMPLETED,4652.56
CARD_PAYMENT,Current,2023-11-11 13:02:35,2023-11-13 11:21:28,Pizzalandia Due,-3.50,0.00,EUR,COMPLETED,4649.06
CARD_PAYMENT,Current,2023-11-13 13:10:55,2023-11-14 10:19:47,Politecnico di Milano,-7.40,0.00,EUR,COMPLETED,4641.66
CARD_PAYMENT,Current,2023-11-11 19:48:15,2023-11-14 12:38:46,Panificio Pasticceria,-8.00,0.00,EUR,COMPLETED,4633.66
CARD_PAYMENT,Current,2023-11-14 13:28:23,2023-11-15 16:12:54,Politecnico di Milano,-7.40,0.00,EUR,COMPLETED,4626.26
CARD_PAYMENT,Current,2023-11-15 12:57:57,2023-11-16 18:04:22,Esselunga,-13.12,0.00,EUR,COMPLETED,4613.14
CARD_PAYMENT,Current,2023-11-16 13:06:56,2023-11-17 11:52:34,Politecnico di Milano,-7.40,0.00,EUR,COMPLETED,4605.74
CARD_PAYMENT,Current,2023-11-15 13:01:07,2023-11-17 12:53:03,Panificio Pasticceria,-12.50,0.00,EUR,COMPLETED,4593.24
CARD_PAYMENT,Current,2023-11-16 08:08:14,2023-11-17 13:53:35,Jolly Student Food,-2.80,0.00,EUR,COMPLETED,4590.44
CARD_PAYMENT,Current,2023-11-17 20:17:49,2023-11-18 12:37:16,Esselunga,-10.61,0.00,EUR,COMPLETED,4579.83
CARD_PAYMENT,Current,2023-11-17 13:01:59,2023-11-18 12:43:22,Politecnico di Milano,-7.40,0.00,EUR,COMPLETED,4572.43
CARD_PAYMENT,Current,2023-11-18 09:21:18,2023-11-19 10:41:55,Jolly Student Food,-2.80,0.00,EUR,COMPLETED,4569.63
CARD_PAYMENT,Current,2023-11-18 18:32:59,2023-11-19 14:32:07,Legami,-28.80,0.00,EUR,COMPLETED,4540.83
CARD_PAYMENT,Current,2023-11-18 13:06:42,2023-11-20 10:43:30,Carrefour,-3.89,0.00,EUR,COMPLETED,4536.94
CARD_PAYMENT,Current,2023-11-19 19:50:33,2023-11-20 10:43:30,Carrefour,-7.43,0.00,EUR,COMPLETED,4529.51
CARD_PAYMENT,Current,2023-11-19 13:47:58,2023-11-20 10:45:06,Sogedai,-0.80,0.00,EUR,COMPLETED,4528.71
CARD_PAYMENT,Current,2023-11-19 11:01:41,2023-11-20 10:45:06,Sogedai,-0.80,0.00,EUR,COMPLETED,4527.91
CARD_PAYMENT,Current,2023-11-19 10:00:44,2023-11-20 11:10:50,Esselunga,-12.77,0.00,EUR,COMPLETED,4515.14
CARD_PAYMENT,Current,2023-11-23 09:02:39,2023-11-24 10:50:52,Politecnico Leonardo,-2.10,0.00,EUR,COMPLETED,4513.04
CARD_PAYMENT,Current,2023-11-22 20:27:08,2023-11-24 16:26:57,Panificio Pasticceria,-8.90,0.00,EUR,COMPLETED,4504.14
CARD_PAYMENT,Current,2023-11-24 13:15:03,2023-11-25 13:26:11,Politecnico di Milano,-7.40,0.00,EUR,COMPLETED,4496.74
TRANSFER,Current,2023-11-25 16:32:44,2023-11-25 16:32:44,From NICOLA TUMMOLO,0.75,0.00,EUR,COMPLETED,4497.49
CARD_PAYMENT,Current,2023-11-24 12:50:07,2023-11-25 17:27:14,Amazon,-206.18,0.00,EUR,COMPLETED,4291.31
CARD_PAYMENT,Current,2023-11-25 20:33:48,2023-11-27 10:53:25,Carrefour,-14.75,0.00,EUR,COMPLETED,4276.56
CARD_PAYMENT,Current,2023-11-26 13:20:03,2023-11-27 10:53:26,Carrefour,-4.38,0.00,EUR,COMPLETED,4272.18
CARD_PAYMENT,Current,2023-11-25 13:16:15,2023-11-27 10:53:26,Carrefour,-9.39,0.00,EUR,COMPLETED,4262.79
CARD_PAYMENT,Current,2023-11-26 16:54:00,2023-11-27 11:53:44,Terranova,-94.20,0.00,EUR,COMPLETED,4168.59
CARD_PAYMENT,Current,2023-11-26 16:26:41,2023-11-27 12:38:30,PittaRosso,-32.19,0.00,EUR,COMPLETED,4136.40
CARD_PAYMENT,Current,2023-11-27 19:52:49,2023-11-28 18:08:35,Esselunga,-6.55,0.00,EUR,COMPLETED,4129.85
CARD_PAYMENT,Current,2023-11-27 19:56:14,2023-11-29 12:07:09,Panificio Pasticceria,-7.75,0.00,EUR,COMPLETED,4122.10
CARD_PAYMENT,Current,2023-11-29 20:39:41,2023-11-30 19:06:05,Carrefour,-26.14,0.00,EUR,COMPLETED,4095.96
CARD_PAYMENT,Current,2023-11-29 10:18:59,2023-12-01 13:21:48,Trenitalia,-38.60,0.00,EUR,COMPLETED,4057.36
CARD_PAYMENT,Current,2023-12-02 21:56:33,2023-12-03 17:36:04,Chiosco Bar Isola Verde,-9.00,0.00,EUR,COMPLETED,4048.36
CARD_PAYMENT,Current,2023-12-03 19:05:36,2023-12-04 10:44:07,Carrefour,-11.70,0.00,EUR,COMPLETED,4036.66
CARD_PAYMENT,Current,2023-12-02 08:31:32,2023-12-04 10:44:07,Carrefour,-1.59,0.00,EUR,COMPLETED,4035.07
CARD_PAYMENT,Current,2023-12-03 13:42:52,2023-12-04 10:44:07,Carrefour,-11.04,0.00,EUR,COMPLETED,4024.03
CARD_PAYMENT,Current,2023-12-04 16:50:17,2023-12-05 10:54:25,Carrefour,-10.69,0.00,EUR,COMPLETED,4013.34
CARD_PAYMENT,Current,2023-12-04 02:52:39,2023-12-05 13:11:11,iliad,-9.99,0.00,EUR,COMPLETED,4003.35
CARD_PAYMENT,Current,2023-12-05 12:16:36,2023-12-06 10:45:55,Comune Mi Anag.de Benede,-16.52,0.00,EUR,COMPLETED,3986.83
CARD_PAYMENT,Current,2023-12-06 12:47:55,2023-12-07 12:42:19,Acm Services Srl 4,-200.00,0.00,EUR,COMPLETED,3786.83
CARD_PAYMENT,Current,2023-12-06 13:30:21,2023-12-07 12:43:53,Pizzalandia Due,-7.00,0.00,EUR,COMPLETED,3779.83
CARD_PAYMENT,Current,2023-12-07 11:33:21,2023-12-08 12:22:12,Stringhetto Fabrizio ..,-14.00,0.00,EUR,COMPLETED,3765.83
CARD_PAYMENT,Current,2023-12-07 11:34:39,2023-12-08 12:48:51,Gusti Del Mediterraneo S,-3.50,0.00,EUR,COMPLETED,3762.33
CARD_PAYMENT,Current,2023-12-06 20:17:08,2023-12-08 12:55:33,Panificio Pasticceria,-7.00,0.00,EUR,COMPLETED,3755.33
CARD_PAYMENT,Current,2023-12-07 18:44:22,2023-12-08 12:59:05,Senstation On Ice Food,-5.00,0.00,EUR,COMPLETED,3750.33
CARD_PAYMENT,Current,2023-12-07 19:08:04,2023-12-08 12:59:05,Senstation On Ice,-9.00,0.00,EUR,COMPLETED,3741.33
CARD_PAYMENT,Current,2023-12-07 13:13:09,2023-12-08 13:35:29,Altro Impero,-6.00,0.00,EUR,COMPLETED,3735.33
CARD_PAYMENT,Current,2023-12-08 19:09:56,2023-12-09 15:13:37,Esselunga,-24.07,0.00,EUR,COMPLETED,3711.26
CARD_PAYMENT,Current,2023-12-07 23:51:56,2023-12-09 15:35:18,Juicebar,-19.60,0.00,EUR,COMPLETED,3691.66
CARD_PAYMENT,Current,2023-12-07 23:52:14,2023-12-09 15:35:18,Juicebar,-2.00,0.00,EUR,COMPLETED,3689.66
CARD_PAYMENT,Current,2023-12-07 15:36:41,2023-12-09 15:45:20,Gest.ristoranti Fornitur,-1.50,0.00,EUR,COMPLETED,3688.16
CARD_PAYMENT,Current,2023-12-07 12:18:56,2023-12-09 15:45:39,Alpidee,-10.00,0.00,EUR,COMPLETED,3678.16
CARD_PAYMENT,Current,2023-12-07 12:05:50,2023-12-10 13:15:32,Mercatini Di Natale Flove,-29.05,0.00,EUR,COMPLETED,3649.11
CARD_PAYMENT,Current,2023-12-07 07:56:01,2023-12-10 13:15:32,Trenitalia,-12.75,0.00,EUR,COMPLETED,3636.36
CARD_PAYMENT,Current,2023-12-07 15:36:13,2023-12-10 13:15:32,Trenitalia,-12.75,0.00,EUR,COMPLETED,3623.61
CARD_PAYMENT,Current,2023-12-09 13:36:38,2023-12-11 11:36:06,Carrefour,-1.71,0.00,EUR,COMPLETED,3621.90
CARD_PAYMENT,Current,2023-12-10 13:11:47,2023-12-11 11:36:06,Carrefour,-5.69,0.00,EUR,COMPLETED,3616.21
CARD_PAYMENT,Current,2023-12-10 17:40:32,2023-12-11 12:21:33,Hollywood Kart Bicocca,-35.00,0.00,EUR,COMPLETED,3581.21
CARD_PAYMENT,Current,2023-12-11 13:56:53,2023-12-12 11:57:02,Carrefour,-5.18,0.00,EUR,COMPLETED,3576.03
CARD_PAYMENT,Current,2023-12-11 17:23:16,2023-12-12 12:00:40,Terra gelato,-3.50,0.00,EUR,COMPLETED,3572.53
CARD_PAYMENT,Current,2023-12-11 17:35:16,2023-12-12 12:05:21,Mg Stampa Snc Di Roberto,-32.00,0.00,EUR,COMPLETED,3540.53
CARD_PAYMENT,Current,2023-12-12 20:12:19,2023-12-13 12:56:19,Fast Food Class,-7.00,0.00,EUR,COMPLETED,3533.53
CARD_PAYMENT,Current,2023-12-14 19:59:09,2023-12-15 11:59:57,Esselunga,-7.64,0.00,EUR,COMPLETED,3525.89
CARD_PAYMENT,Current,2023-12-13 13:32:01,2023-12-15 13:01:35,Panificio Pasticceria,-19.60,0.00,EUR,COMPLETED,3506.29
CARD_PAYMENT,Current,2023-12-15 19:50:36,2023-12-16 13:18:50,Esselunga,-15.49,0.00,EUR,COMPLETED,3490.80
CARD_PAYMENT,Current,2023-12-15 12:58:12,2023-12-16 13:27:10,Politecnico di Milano,-2.11,0.00,EUR,COMPLETED,3488.69
CARD_PAYMENT,Current,2023-12-16 23:00:37,2023-12-17 13:22:58,Il Pomodorino,-213.50,0.00,EUR,COMPLETED,3275.19
CARD_PAYMENT,Current,2023-12-17 19:12:36,2023-12-18 11:44:02,Carrefour,-4.26,0.00,EUR,COMPLETED,3270.93
CARD_PAYMENT,Current,2023-12-16 11:49:08,2023-12-18 12:22:15,Esselunga,-9.71,0.00,EUR,COMPLETED,3261.22
CARD_PAYMENT,Current,2023-12-16 11:06:32,2023-12-18 12:52:16,Terranova,-65.95,0.00,EUR,COMPLETED,3195.27
CARD_PAYMENT,Current,2023-12-17 00:13:53,2023-12-18 13:43:23,Il Pomodorino,-40.00,0.00,EUR,COMPLETED,3155.27
CARD_PAYMENT,Current,2023-12-18 13:10:42,2023-12-19 14:18:44,Pellegrini Horse Butcher Shop,-9.00,0.00,EUR,COMPLETED,3146.27
CARD_PAYMENT,Current,2023-12-19 16:05:18,2023-12-20 14:03:20,Francesco Mand,-30.00,0.00,EUR,COMPLETED,3116.27
CARD_PAYMENT,Current,2023-12-20 14:13:18,2023-12-21 12:26:53,Tolstoi56,-4.21,0.00,EUR,COMPLETED,3112.06
CARD_PAYMENT,Current,2023-12-19 17:28:04,2023-12-21 13:26:22,Panificio Pasticceria,-10.00,0.00,EUR,COMPLETED,3102.06
CARD_PAYMENT,Current,2023-12-21 14:21:01,2023-12-22 14:17:57,Maffus,-12.96,0.00,EUR,COMPLETED,3089.10
CARD_PAYMENT,Current,2023-12-20 18:44:29,2023-12-22 17:40:55,Lloyds Farmacia,-22.10,0.00,EUR,COMPLETED,3067.00
CARD_PAYMENT,Current,2023-12-20 18:49:02,2023-12-22 17:40:55,Panificio Pasticceria,-8.40,0.00,EUR,COMPLETED,3058.60
CARD_PAYMENT,Current,2023-12-21 19:26:40,2023-12-22 17:54:23,H&M,-52.16,0.00,EUR,COMPLETED,3006.44
CARD_PAYMENT,Current,2023-12-23 19:10:06,2023-12-25 11:28:36,Pam Panorama,-3.60,0.00,EUR,COMPLETED,3002.84
CARD_PAYMENT,Current,2023-12-23 20:09:47,2023-12-25 11:44:18,A2A Energia,-87.00,0.00,EUR,COMPLETED,2915.84
CARD_PAYMENT,Current,2023-12-27 12:36:25,2023-12-28 12:20:13,Fresco Padova,-40.50,0.00,EUR,COMPLETED,2875.34
CARD_PAYMENT,Current,2023-12-27 07:59:15,2023-12-28 18:49:19,Trenitalia,-30.30,0.00,EUR,COMPLETED,2845.04
CARD_PAYMENT,Current,2023-12-28 10:01:06,2023-12-29 19:20:28,Pam Panorama,-11.44,0.00,EUR,COMPLETED,2833.60
CARD_PAYMENT,Current,2023-12-30 15:47:29,2024-01-01 16:22:54,Conad,-30.68,0.00,EUR,COMPLETED,2802.92
CARD_PAYMENT,Current,2024-01-01 19:51:29,2024-01-03 10:57:48,Trenitalia,-51.60,0.00,EUR,COMPLETED,2751.32
CARD_PAYMENT,Current,2024-01-04 02:46:48,2024-01-05 12:34:49,iliad,-9.99,0.00,EUR,COMPLETED,2741.33
CARD_PAYMENT,Current,2024-01-04 12:15:32,2024-01-05 13:08:18,Esselunga,-1.74,0.00,EUR,COMPLETED,2739.59
CARD_PAYMENT,Current,2024-01-04 18:12:01,2024-01-05 13:14:40,Lauro Natale Snc,-5.00,0.00,EUR,COMPLETED,2734.59
CARD_PAYMENT,Current,2024-01-05 19:51:20,2024-01-06 11:24:10,Carrefour,-5.56,0.00,EUR,COMPLETED,2729.03
CARD_PAYMENT,Current,2024-01-05 12:58:18,2024-01-06 11:24:10,Carrefour,-5.94,0.00,EUR,COMPLETED,2723.09
CARD_PAYMENT,Current,2024-01-06 13:37:35,2024-01-09 11:05:37,Esselunga,-5.49,0.00,EUR,COMPLETED,2717.60
CARD_PAYMENT,Current,2024-01-09 17:36:47,2024-01-10 13:18:41,Esselunga,-8.66,0.00,EUR,COMPLETED,2708.94
CARD_PAYMENT,Current,2024-01-11 14:42:01,2024-01-12 12:19:53,Traduzioni Giurate In Tr,-100.00,0.00,EUR,COMPLETED,2608.94
TRANSFER,Current,2024-01-14 11:40:57,2024-01-14 11:40:59,To Stock House Sas,-575.00,0.00,EUR,COMPLETED,2033.94
CARD_PAYMENT,Current,2024-01-12 20:33:41,2024-01-15 10:28:47,Carrefour,-8.17,0.00,EUR,COMPLETED,2025.77
CARD_PAYMENT,Current,2024-01-12 13:01:54,2024-01-15 10:45:38,Politecnico di Milano,-7.40,0.00,EUR,COMPLETED,2018.37
CARD_PAYMENT,Current,2024-01-13 15:06:05,2024-01-15 18:09:31,Jolly Student Food,-1.40,0.00,EUR,COMPLETED,2016.97
CARD_PAYMENT,Current,2024-01-14 13:01:57,2024-01-16 01:42:34,Carrefour,-6.94,0.00,EUR,COMPLETED,2010.03
CARD_PAYMENT,Current,2024-01-13 19:59:38,2024-01-16 01:56:40,Esselunga,-15.13,0.00,EUR,COMPLETED,1994.90
CARD_PAYMENT,Current,2024-01-13 12:54:08,2024-01-16 02:10:21,Pizzalandia Due,-21.50,0.00,EUR,COMPLETED,1973.40
CARD_PAYMENT,Current,2024-01-15 07:50:45,2024-01-16 10:15:04,Piola Cafė,-3.10,0.00,EUR,COMPLETED,1970.30
CARD_PAYMENT,Current,2024-01-15 12:51:36,2024-01-16 14:00:51,Politecnico di Milano,-7.40,0.00,EUR,COMPLETED,1962.90
CARD_PAYMENT,Current,2024-01-16 13:20:56,2024-01-17 11:16:11,Tailor food'n kitchen Pellegrini Bovisa,-6.30,0.00,EUR,COMPLETED,1956.60
CARD_PAYMENT,Current,2024-01-16 20:46:52,2024-01-17 12:32:20,Esselunga,-12.36,0.00,EUR,COMPLETED,1944.24
CARD_PAYMENT,Current,2024-01-17 12:35:54,2024-01-18 12:53:09,Politecnico Campus Bovis,-7.40,0.00,EUR,COMPLETED,1936.84
CARD_PAYMENT,Current,2024-01-18 20:01:45,2024-01-19 13:13:23,Esselunga,-18.27,0.00,EUR,COMPLETED,1918.57
CARD_PAYMENT,Current,2024-01-18 13:07:06,2024-01-19 13:18:11,Politecnico di Milano,-7.40,0.00,EUR,COMPLETED,1911.17
CARD_PAYMENT,Current,2024-01-19 20:14:17,2024-01-20 11:09:19,Esselunga,-8.57,0.00,EUR,COMPLETED,1902.60
CARD_PAYMENT,Current,2024-01-19 18:19:22,2024-01-20 11:09:21,Esselunga,-17.51,0.00,EUR,COMPLETED,1885.09
CARD_PAYMENT,Current,2024-01-22 19:48:37,2024-01-23 13:06:07,Carrefour,-2.76,0.00,EUR,COMPLETED,1882.33
CARD_PAYMENT,Current,2024-01-22 11:35:13,2024-01-23 13:06:07,Carrefour,-2.50,0.00,EUR,COMPLETED,1879.83
CARD_PAYMENT,Current,2024-01-23 13:05:04,2024-01-24 13:47:19,Politecnico di Milano,-7.40,0.00,EUR,COMPLETED,1872.43
CARD_PAYMENT,Current,2024-01-24 12:58:02,2024-01-25 12:30:20,Politecnico di Milano,-7.40,0.00,EUR,COMPLETED,1865.03
TRANSFER,Current,2024-01-25 23:56:21,2024-01-25 23:56:21,To NICOLA TUMMOLO,-6.00,0.00,EUR,COMPLETED,1859.03
CARD_PAYMENT,Current,2024-01-26 20:13:27,2024-01-27 10:46:57,Carrefour,-15.75,0.00,EUR,COMPLETED,1843.28
CARD_PAYMENT,Current,2024-01-26 08:01:13,2024-01-27 11:22:42,Piola Cafė,-3.10,0.00,EUR,COMPLETED,1840.18
CARD_PAYMENT,Current,2024-01-28 12:58:59,2024-01-29 11:22:27,Carrefour,-14.68,0.00,EUR,COMPLETED,1825.50
CARD_PAYMENT,Current,2024-01-27 12:54:03,2024-01-29 11:44:24,Pizzalandia Due,-8.50,0.00,EUR,COMPLETED,1817.00
CARD_PAYMENT,Current,2024-01-26 12:48:58,2024-01-29 11:50:01,Politecnico di Milano,-7.40,0.00,EUR,COMPLETED,1809.60
CARD_PAYMENT,Current,2024-01-29 14:43:32,2024-01-30 10:31:25,Carrefour,-0.29,0.00,EUR,COMPLETED,1809.31
CARD_PAYMENT,Current,2024-01-29 19:42:39,2024-01-30 10:38:10,Esselunga,-13.39,0.00,EUR,COMPLETED,1795.92
CARD_PAYMENT,Current,2024-01-30 19:57:49,2024-01-31 15:55:28,Esselunga,-13.77,0.00,EUR,COMPLETED,1782.15
CARD_PAYMENT,Current,2024-01-30 13:00:03,2024-01-31 15:57:25,Politecnico di Milano,-7.40,0.00,EUR,COMPLETED,1774.75
CARD_PAYMENT,Current,2024-01-31 12:47:48,2024-02-01 10:41:21,Politecnico di Milano,-14.80,0.00,EUR,COMPLETED,1759.95
CARD_PAYMENT,Current,2024-02-02 19:22:55,2024-02-03 12:55:50,Esselunga,-15.56,0.00,EUR,COMPLETED,1744.39
CARD_PAYMENT,Current,2024-02-02 13:05:01,2024-02-03 13:00:35,Politecnico di Milano,-7.40,0.00,EUR,COMPLETED,1736.99
CARD_PAYMENT,Current,2024-02-04 03:01:56,2024-02-05 11:37:53,iliad,-9.99,0.00,EUR,COMPLETED,1727.00
CARD_PAYMENT,Current,2024-02-04 13:00:10,2024-02-05 11:51:21,Carrefour,-6.69,0.00,EUR,COMPLETED,1720.31
CARD_PAYMENT,Current,2024-02-03 13:11:24,2024-02-05 12:15:23,Istanbul Politecnico Turkish Pizza Kebap,-13.50,0.00,EUR,COMPLETED,1706.81
CARD_PAYMENT,Current,2024-02-05 12:51:45,2024-02-06 11:56:33,Politecnico di Milano,-7.40,0.00,EUR,COMPLETED,1699.41
CARD_PAYMENT,Current,2024-02-07 13:00:48,2024-02-08 11:29:56,Politecnico di Milano,-7.40,0.00,EUR,COMPLETED,1692.01
CARD_PAYMENT,Current,2024-02-07 18:20:39,2024-02-08 13:52:15,Pasticceria Bernasconi,-24.00,0.00,EUR,COMPLETED,1668.01
CARD_PAYMENT,Current,2024-02-08 19:33:04,2024-02-09 11:27:05,Esselunga,-2.88,0.00,EUR,COMPLETED,1665.13
CARD_PAYMENT,Current,2024-02-08 12:58:09,2024-02-09 11:30:06,Politecnico di Milano,-7.40,0.00,EUR,COMPLETED,1657.73
CARD_PAYMENT,Current,2024-02-08 14:42:16,2024-02-09 12:41:53,PoliPrint,-3.20,0.00,EUR,COMPLETED,1654.53
CARD_PAYMENT,Current,2024-02-08 19:35:10,2024-02-10 13:17:26,Panificio Pasticceria,-10.90,0.00,EUR,COMPLETED,1643.63
CARD_PAYMENT,Current,2024-02-11 12:56:21,2024-02-12 11:54:33,Carrefour,-5.32,0.00,EUR,COMPLETED,1638.31
CARD_PAYMENT,Current,2024-02-10 13:02:34,2024-02-12 11:54:36,Carrefour,-5.98,0.00,EUR,COMPLETED,1632.33
CARD_PAYMENT,Current,2024-02-12 15:40:41,2024-02-13 11:56:26,laFeltrinelli Librerie,-34.00,0.00,EUR,COMPLETED,1598.33
CARD_PAYMENT,Current,2024-02-12 13:38:38,2024-02-13 12:10:21,Burger King,-9.10,0.00,EUR,COMPLETED,1589.23
CARD_PAYMENT,Current,2024-02-12 15:04:31,2024-02-13 12:11:09,Associazione Territor..,-16.50,0.00,EUR,COMPLETED,1572.73
CARD_PAYMENT,Current,2024-02-13 19:21:59,2024-02-14 11:32:33,Esselunga,-11.31,0.00,EUR,COMPLETED,1561.42
CARD_PAYMENT,Current,2024-02-14 22:43:20,2024-02-15 11:45:20,Castello Nuovo,-15.00,0.00,EUR,COMPLETED,1546.42
CARD_PAYMENT,Current,2024-02-14 14:26:41,2024-02-15 11:47:24,Odontoiatrica S. Michele,-29.00,0.00,EUR,COMPLETED,1517.42
CARD_PAYMENT,Current,2024-02-15 12:55:59,2024-02-16 12:14:26,Politecnico di Milano,-12.44,0.00,EUR,COMPLETED,1504.98
CARD_PAYMENT,Current,2024-02-14 10:03:39,2024-02-16 13:29:38,Lloyds Farmacia,-2.76,0.00,EUR,COMPLETED,1502.22
CARD_PAYMENT,Current,2024-02-15 09:18:59,2024-02-17 14:19:48,Lloyds Farmacia,-6.20,0.00,EUR,COMPLETED,1496.02
CARD_PAYMENT,Current,2024-02-18 14:27:19,2024-02-19 12:20:13,Weiner Haus Milano Bicoc,-21.70,0.00,EUR,COMPLETED,1474.32
CARD_PAYMENT,Current,2024-02-20 12:01:43,2024-02-21 10:59:31,Politecnico di Milano,-7.40,0.00,EUR,COMPLETED,1466.92
CARD_PAYMENT,Current,2024-02-21 20:20:42,2024-02-22 11:08:01,Esselunga,-20.33,0.00,EUR,COMPLETED,1446.59
CARD_PAYMENT,Current,2024-02-21 19:36:47,2024-02-22 11:27:40,Decathlon,-20.49,0.00,EUR,COMPLETED,1426.10
TRANSFER,Current,2024-02-22 18:31:50,2024-02-22 18:31:50,From RONGOU ZHOU,15.00,0.00,EUR,COMPLETED,1441.10
CARD_PAYMENT,Current,2024-02-22 18:21:25,2024-02-23 13:03:20,Fantamagus,-30.00,0.00,EUR,COMPLETED,1411.10
CARD_PAYMENT,Current,2024-02-23 19:21:36,2024-02-24 12:15:51,Carrefour,-14.19,0.00,EUR,COMPLETED,1396.91
CARD_PAYMENT,Current,2024-02-23 11:23:07,2024-02-24 18:28:48,Pellegrini Horse Butcher Shop,-4.50,0.00,EUR,COMPLETED,1392.41
CARD_PAYMENT,Current,2024-02-24 21:28:08,2024-02-25 12:08:33,Cocciutoturatimenu.qro,-17.92,0.00,EUR,COMPLETED,1374.49
CARD_PAYMENT,Current,2024-02-24 17:50:43,2024-02-26 11:47:41,Carrefour,-9.24,0.00,EUR,COMPLETED,1365.25
CARD_PAYMENT,Current,2024-02-27 19:17:31,2024-02-28 11:12:30,Carrefour,-9.75,0.00,EUR,COMPLETED,1355.50
CARD_PAYMENT,Current,2024-02-28 13:27:26,2024-02-29 12:59:40,Jolly Student Food,-1.20,0.00,EUR,COMPLETED,1354.30
CARD_PAYMENT,Current,2024-03-01 10:13:40,2024-03-02 10:40:37,Pellegrini Horse Butcher Shop,-2.20,0.00,EUR,COMPLETED,1352.10
CARD_PAYMENT,Current,2024-03-01 11:09:56,2024-03-02 10:40:40,Pellegrini Horse Butcher Shop,-4.50,0.00,EUR,COMPLETED,1347.60
CARD_PAYMENT,Current,2024-03-01 19:33:44,2024-03-02 12:41:45,Carrefour,-11.66,0.00,EUR,COMPLETED,1335.94
CARD_PAYMENT,Current,2024-03-04 18:58:40,2024-03-05 12:15:04,Esselunga,-17.71,0.00,EUR,COMPLETED,1318.23
CARD_PAYMENT,Current,2024-03-04 19:46:09,2024-03-05 12:21:54,A2A Energia,-86.00,0.00,EUR,COMPLETED,1232.23
CARD_PAYMENT,Current,2024-03-04 08:10:11,2024-03-05 14:08:02,R79 Baciami Ancora,-1.50,0.00,EUR,COMPLETED,1230.73
CARD_PAYMENT,Current,2024-03-04 13:15:08,2024-03-05 14:08:07,La Cantina del Mangia,-10.00,0.00,EUR,COMPLETED,1220.73
CARD_PAYMENT,Current,2024-03-04 02:58:25,2024-03-06 09:46:53,iliad,-9.99,0.00,EUR,COMPLETED,1210.74
CARD_PAYMENT,Current,2024-03-05 08:10:43,2024-03-06 12:22:18,Jolly Student Food,-2.80,0.00,EUR,COMPLETED,1207.94
CARD_PAYMENT,Current,2024-03-06 18:57:41,2024-03-07 12:31:03,Esselunga,-11.19,0.00,EUR,COMPLETED,1196.75
CARD_PAYMENT,Current,2024-03-06 13:37:32,2024-03-07 13:10:37,La Cantina del Mangia,-8.50,0.00,EUR,COMPLETED,1188.25
TRANSFER,Current,2024-03-07 20:01:59,2024-03-07 20:02:04,To Stock House Sas,-575.00,0.00,EUR,COMPLETED,613.25
CARD_PAYMENT,Current,2024-03-07 08:11:05,2024-03-08 12:48:23,Politecnico Giurati,-5.80,0.00,EUR,COMPLETED,607.45
TRANSFER,Current,2024-03-08 14:38:35,2024-03-08 14:38:41,To Gabriele Tonello,-50.00,0.00,EUR,COMPLETED,557.45
CARD_PAYMENT,Current,2024-03-08 19:38:26,2024-03-09 17:32:35,Carrefour,-17.07,0.00,EUR,COMPLETED,540.38
CARD_PAYMENT,Current,2024-03-08 10:38:47,2024-03-09 18:33:55,Pellegrini Horse Butcher Shop,-4.50,0.00,EUR,COMPLETED,535.88
CARD_PAYMENT,Current,2024-03-08 10:23:55,2024-03-09 18:33:55,Pellegrini Horse Butcher Shop,-2.20,0.00,EUR,COMPLETED,533.68
CARD_PAYMENT,Current,2024-03-08 11:26:15,2024-03-09 18:33:57,Pellegrini Horse Butcher Shop,-2.40,0.00,EUR,COMPLETED,531.28
CARD_PAYMENT,Current,2024-03-09 19:37:48,2024-03-11 19:35:40,Esselunga,-24.64,0.00,EUR,COMPLETED,506.64
CARD_PAYMENT,Current,2024-03-09 18:40:21,2024-03-11 19:35:43,Esselunga,-6.34,0.00,EUR,COMPLETED,500.30
CARD_PAYMENT,Current,2024-03-13 18:28:21,2024-03-14 17:04:47,Carrefour,-6.97,0.00,EUR,COMPLETED,493.33
CARD_PAYMENT,Current,2024-03-13 13:11:51,2024-03-14 18:11:30,La Cantina del Mangia,-10.00,0.00,EUR,COMPLETED,483.33
CARD_PAYMENT,Current,2024-03-14 07:47:04,2024-03-15 15:16:25,Il Bancale,-3.50,0.00,EUR,COMPLETED,479.83
CARD_PAYMENT,Current,2024-03-15 20:24:51,2024-03-16 13:03:37,Esselunga,-10.25,0.00,EUR,COMPLETED,469.58
CARD_PAYMENT,Current,2024-03-15 14:02:57,2024-03-16 13:39:05,Laesse Di Citta Studi,-0.98,0.00,EUR,COMPLETED,468.60
CARD_PAYMENT,Current,2024-03-15 12:40:20,2024-03-16 13:45:53,Pellegrini Horse Butcher Shop,-3.30,0.00,EUR,COMPLETED,465.30
CARD_PAYMENT,Current,2024-03-15 09:11:56,2024-03-16 13:45:56,Pellegrini Horse Butcher Shop,-2.40,0.00,EUR,COMPLETED,462.90
TRANSFER,Current,2024-03-17 01:11:36,2024-03-17 01:11:38,To Gabriele Tonello,-15.00,0.00,EUR,COMPLETED,447.90
TRANSFER,Current,2024-03-17 01:43:19,2024-03-17 01:43:21,To Gabriele Tonello,-15.00,0.00,EUR,COMPLETED,432.90
CARD_PAYMENT,Current,2024-03-16 14:54:24,2024-03-17 13:43:15,Jolly Student Food,-1.20,0.00,EUR,COMPLETED,431.70
CARD_PAYMENT,Current,2024-03-16 13:55:00,2024-03-17 13:43:16,Jolly Student Food,-2.40,0.00,EUR,COMPLETED,429.30
CARD_PAYMENT,Current,2024-03-16 12:02:57,2024-03-18 14:42:25,Carrefour,-6.50,0.00,EUR,COMPLETED,422.80
CARD_PAYMENT,Current,2024-03-17 12:50:36,2024-03-18 14:42:27,Carrefour,-8.89,0.00,EUR,COMPLETED,413.91
CARD_PAYMENT,Current,2024-03-18 18:44:41,2024-03-19 11:09:36,Gran Market 5 S.r.l. ..,-1.99,0.00,EUR,COMPLETED,411.92
CARD_PAYMENT,Current,2024-03-18 14:48:24,2024-03-19 15:45:15,Metrosapi,-2.40,0.00,EUR,COMPLETED,409.52
CARD_PAYMENT,Current,2024-03-19 08:29:08,2024-03-20 10:43:34,Politecnico Leonardo,-3.50,0.00,EUR,COMPLETED,406.02
CARD_PAYMENT,Current,2024-03-19 12:01:00,2024-03-20 10:43:34,Politecnico di Milano,-7.40,0.00,EUR,COMPLETED,398.62
CARD_PAYMENT,Current,2024-03-19 12:33:18,2024-03-20 10:43:38,Politecnico Leonardo,-1.20,0.00,EUR,COMPLETED,397.42
CARD_PAYMENT,Current,2024-03-20 19:26:45,2024-03-21 11:01:11,Esselunga,-29.80,0.00,EUR,COMPLETED,367.62
CARD_PAYMENT,Current,2024-03-20 13:07:51,2024-03-21 11:14:47,Anatolia Kebab & Pizza Milano,-7.50,0.00,EUR,COMPLETED,360.12
CARD_PAYMENT,Current,2024-03-22 18:28:31,2024-03-23 11:34:36,Esselunga,-14.98,0.00,EUR,COMPLETED,345.14
CARD_PAYMENT,Current,2024-03-23 09:35:58,2024-03-24 11:48:07,Jolly Student Food,-1.30,0.00,EUR,COMPLETED,343.84
CARD_PAYMENT,Current,2024-03-24 13:47:41,2024-03-25 10:49:56,Carrefour,-5.30,0.00,EUR,COMPLETED,338.54
CARD_PAYMENT,Current,2024-03-23 12:52:12,2024-03-25 11:14:53,Pizzalandia Due,-8.50,0.00,EUR,COMPLETED,330.04
CARD_PAYMENT,Current,2024-03-25 18:53:13,2024-03-26 11:53:28,Kasanova,-7.90,0.00,EUR,COMPLETED,322.14
CARD_PAYMENT,Current,2024-03-26 12:05:33,2024-03-27 11:05:48,Politecnico di Milano,-7.40,0.00,EUR,COMPLETED,314.74
CARD_PAYMENT,Current,2024-03-29 14:01:28,2024-03-30 10:53:41,Carrefour,-2.58,0.00,EUR,COMPLETED,312.16
CARD_PAYMENT,Current,2024-04-01 20:45:02,2024-04-02 15:19:10,ets.org,-44.60,0.00,EUR,COMPLETED,267.56
CARD_PAYMENT,Current,2024-03-31 09:52:44,2024-04-03 11:52:50,Trenitalia,-4.40,0.00,EUR,COMPLETED,263.16
CARD_PAYMENT,Current,2024-03-30 09:54:29,2024-04-03 11:52:53,Trenitalia,-4.40,0.00,EUR,COMPLETED,258.76
CARD_PAYMENT,Current,2024-04-02 13:08:22,2024-04-03 12:19:10,Politecnico di Milano,-7.40,0.00,EUR,COMPLETED,251.36
CARD_PAYMENT,Current,2024-04-02 09:13:53,2024-04-03 12:33:41,Jolly Student Food,-2.50,0.00,EUR,COMPLETED,248.86
CARD_PAYMENT,Current,2024-04-02 16:06:04,2024-04-03 12:34:24,Jolly Student Food,-1.20,0.00,EUR,COMPLETED,247.66
CARD_PAYMENT,Current,2024-04-02 19:21:13,2024-04-03 16:09:26,Diva Parrucchiere,-12.00,0.00,EUR,COMPLETED,235.66
CARD_PAYMENT,Current,2024-04-03 13:01:47,2024-04-04 11:07:15,Politecnico di Milano,-7.40,0.00,EUR,COMPLETED,228.26
CARD_PAYMENT,Current,2024-04-04 12:49:53,2024-04-05 11:41:52,Politecnico di Milano,-7.40,0.00,EUR,COMPLETED,220.86
CARD_PAYMENT,Current,2024-04-04 13:49:20,2024-04-05 12:47:49,Jolly Student Food,-4.80,0.00,EUR,COMPLETED,216.06
CARD_PAYMENT,Current,2024-04-06 10:17:12,,Carrefour,-4.74,0.00,EUR,PENDING,
CARD_PAYMENT,Current,2024-04-05 13:15:21,2024-04-06 12:39:00,Pellegrini Horse Butcher Shop,-6.30,0.00,EUR,COMPLETED,209.76
CARD_PAYMENT,Current,2024-04-05 09:27:29,2024-04-06 12:39:00,Pellegrini Horse Butcher Shop,-2.40,0.00,EUR,COMPLETED,207.36
CARD_PAYMENT,Current,2024-04-06 12:44:13,2024-04-07 13:01:39,Lu.da. Snc Pizza,-7.00,0.00,EUR,COMPLETED,200.36
CARD_PAYMENT,Current,2024-04-06 10:17:12,2024-04-08 11:46:37,Carrefour,-4.74,0.00,EUR,COMPLETED,195.62
CARD_PAYMENT,Current,2024-04-07 12:57:01,2024-04-08 11:46:42,Carrefour,-8.35,0.00,EUR,COMPLETED,187.27
CARD_PAYMENT,Current,2024-04-07 19:24:04,2024-04-08 11:46:42,Carrefour,-9.14,0.00,EUR,COMPLETED,178.13
CARD_PAYMENT,Current,2024-04-06 13:32:08,2024-04-08 12:26:39,Politecnico Leonardo,-1.20,0.00,EUR,COMPLETED,176.93
CARD_PAYMENT,Current,2024-04-08 20:36:59,2024-04-09 11:13:04,Carrefour,-11.20,0.00,EUR,COMPLETED,165.73
CARD_PAYMENT,Current,2024-04-12 12:52:00,2024-04-13 12:35:11,Pellegrini Horse Butcher Shop,-5.20,0.00,EUR,COMPLETED,160.53
CARD_PAYMENT,Current,2024-04-12 20:46:15,2024-04-13 13:25:09,Bestia Beer E Street Foo,-15.40,0.00,EUR,COMPLETED,145.13
CARD_PAYMENT,Current,2024-04-15 09:57:30,,Flli Cassetta,-6.00,0.00,EUR,PENDING,
CARD_PAYMENT,Current,2024-04-13 19:25:00,2024-04-15 11:48:58,Carrefour,-4.87,0.00,EUR,COMPLETED,140.26
CARD_PAYMENT,Current,2024-04-13 10:40:18,2024-04-15 11:48:58,Carrefour,-0.27,0.00,EUR,COMPLETED,139.99
CARD_PAYMENT,Current,2024-04-13 11:18:47,2024-04-15 12:23:20,Coeco Bernini,-13.00,0.00,EUR,COMPLETED,126.99
CARD_PAYMENT,Current,2024-04-14 11:01:46,2024-04-15 12:27:32,Esselunga,-8.02,0.00,EUR,COMPLETED,118.97
CARD_PAYMENT,Current,2024-04-14 10:53:02,2024-04-15 12:32:05,Amazon,-44.98,0.00,EUR,COMPLETED,73.99
CARD_PAYMENT,Current,2024-04-15 10:25:50,2024-04-16 11:40:50,Esselunga,-15.12,0.00,EUR,COMPLETED,58.87
CARD_PAYMENT,Current,2024-04-13 00:01:15,2024-04-16 12:08:58,La Forgia Degli Eroi,-6.00,0.00,EUR,COMPLETED,52.87
CARD_PAYMENT,Current,2024-04-15 20:13:03,2024-04-16 12:53:19,Conad,-6.57,0.00,EUR,COMPLETED,46.30
